article_name	discipline
political_science_POLISCY	political_science
religion_ANTHRO	anthropology
anthropology_ANTHRO	anthropology
people_ANTHRO	anthropology
language_ANTHRO	anthropology
adam_smith_ECON	economics
intelligence_PSY	psychology
ideology_SOC	sociology
friedrich_hayek_ECON	economics
slavery_ANTHRO	anthropology
cultural_anthropology_ANTHRO	anthropology
jurisprudence_POLISCY	political_science
propaganda_POLISCY	political_science
private_property_POLISCY	political_science
joseph_schumpeter_ECON	economics
totalitarianism_POLISCY	political_science
index_of_sociology_articles_SOC	sociology
third_way_POLISCY	political_science
nazism_POLISCY	political_science
archaeology_ANTHRO	anthropology
elinor_ostrom_ECON	economics
linguistics_ANTHRO	anthropology
georgism_ECON	economics
index_of_economics_articles_ECON	economics
daniel_kahneman_ECON	economics
technocracy_POLISCY	political_science
foreign_policy_POLISCY	political_science
criticism_of_capitalism_POLISCY	political_science
london_school_of_economics_POLISCY	political_science
john_hicks_ECON	economics
psychometrics_PSY	psychology
psychoanalysis_PSY	psychology
marginalism_ECON	economics
left-wing_politics_POLISCY	political_science
public_administration_POLISCY	political_science
international_law_POLISCY	political_science
bertrand_russell_ECON	economics
rationalism_PSY	psychology
evolutionary_psychology_PSY	psychology
public_economics_ECON	economics
experimental_economics_ECON	economics
index_of_social_and_political_philosophy_articles_POLISCY	political_science
supply_and_demand_ECON	economics
international_economics_ECON	economics
literacy_ANTHRO	anthropology
kenneth_arrow_ECON	economics
glossary_of_economics_ECON	economics
social_experiment_SOC	sociology
populism_POLISCY	political_science
social_complexity_SOC	sociology
freedom_SOC	sociology
cultural_relativism_ANTHRO	anthropology
nation_state_POLISCY	political_science
culture_theory_ANTHRO	anthropology
utility_ECON	economics
financial_economics_ECON	economics
astrosociology_SOC	sociology
anarcho-capitalism_ECON	economics
human_ecology_ANTHRO	anthropology
dictatorship_of_the_proletariat_POLISCY	political_science
oligarchy_POLISCY	political_science
mainstream_economics_ECON	economics
political_party_POLISCY	political_science
creativity_PSY	psychology
surplus_value_ECON	economics
participism_POLISCY	political_science
reactionary_POLISCY	political_science
historical_sociology_SOC	sociology
equal_opportunity_POLISCY	political_science
behavioral_neuroscience_PSY	psychology
proletarian_revolution_POLISCY	political_science
john_rawls_ECON	economics
cultural_movement_ANTHRO	anthropology
reductionism_SOC	sociology
world_revolution_POLISCY	political_science
constitutionalism_POLISCY	political_science
soul_PSY	psychology
developmental_psychology_PSY	psychology
pride_PSY	psychology
e._f._schumacher_POLISCY	political_science
alliance_theory_ANTHRO	anthropology
tyranny_of_the_majority_POLISCY	political_science
industrial_democracy_POLISCY	political_science
workplace_democracy_POLISCY	political_science
history_of_communism_POLISCY	political_science
biological_anthropology_ANTHRO	anthropology
quantitative_research_SOC	sociology
sociological_positivism_SOC	sociology
left_communism_POLISCY	political_science
christian_communism_POLISCY	political_science
base_and_superstructure_SOC	sociology
comparative_politics_POLISCY	political_science
real_socialism_POLISCY	political_science
jel_classification_codes_ECON	economics
statism_POLISCY	political_science
democratic_capitalism_ECON	economics
eastern_bloc_POLISCY	political_science
opportunity_cost_ECON	economics
social_revolution_SOC	sociology
enemy_of_the_people_POLISCY	political_science
fiqh_POLISCY	political_science
new_institutional_economics_ECON	economics
polygyny_ANTHRO	anthropology
behavior_PSY	psychology
harry_harlow_PSY	psychology
psychoanalytic_theory_PSY	psychology
cato_institute_POLISCY	political_science
law_of_equal_liberty_POLISCY	political_science
right-wing_politics_POLISCY	political_science
one-party_state_POLISCY	political_science
william_vickrey_ECON	economics
logology_(science)_POLISCY	political_science
ethnobiology_ANTHRO	anthropology
astrology_PSY	psychology
hedonism_PSY	psychology
phillips_curve_ECON	economics
whiggism_POLISCY	political_science
oppression_SOC	sociology
antipositivism_SOC	sociology
degrowth_SOC	sociology
social_reality_SOC	sociology
feminist_theory_SOC	sociology
democratic_peace_theory_POLISCY	political_science
performance_studies_ANTHRO	anthropology
paul_milgrom_ECON	economics
instrumentalism_SOC	sociology
ecofeminism_SOC	sociology
hunter-gatherer_ANTHRO	anthropology
authoritarian_capitalism_POLISCY	political_science
cultural_liberalism_POLISCY	political_science
far-right_politics_POLISCY	political_science
thomas_schelling_ECON	economics
social_system_SOC	sociology
kindness_PSY	psychology
knowledge_economy_ECON	economics
economic_model_ECON	economics
assume_a_can_opener_ECON	economics
spirituality_PSY	psychology
anti-psychiatry_PSY	psychology
factors_of_production_ECON	economics
hypnosis_PSY	psychology
bryan_caplan_POLISCY	political_science
vernon_l._smith_ECON	economics
social_imperialism_POLISCY	political_science
worker_cooperative_POLISCY	political_science
acceptance_PSY	psychology
emic_and_etic_ANTHRO	anthropology
hostility_PSY	psychology
list_of_liberal_theorists_POLISCY	political_science
confusion_PSY	psychology
macroeconomic_model_ECON	economics
sociology_of_scientific_ignorance_SOC	sociology
constitutional_patriotism_POLISCY	political_science
sciences_po_POLISCY	political_science
non-interventionism_POLISCY	political_science
echo_chamber_(media)_POLISCY	political_science
neglect_PSY	psychology
resentment_PSY	psychology
ecological_anthropology_ANTHRO	anthropology
ordoliberalism_POLISCY	political_science
gratitude_PSY	psychology
pathos_PSY	psychology
outline_of_psychology_PSY	psychology
national_liberalism_POLISCY	political_science
social_liberalism_POLISCY	political_science
brainwashing_PSY	psychology
ethical_socialism_POLISCY	political_science
public_policy_school_POLISCY	political_science
neo-nationalism_ANTHRO	anthropology
wilhelm_windelband_PSY	psychology
amusement_PSY	psychology
area_studies_ANTHRO	anthropology
anguish_PSY	psychology
liberal_conservatism_POLISCY	political_science
purchasing_power_parity_ECON	economics
symbol_SOC	sociology
learning_PSY	psychology
diminishing_returns_ECON	economics
civil_libertarianism_POLISCY	political_science
emotionality_PSY	psychology
nanosocialism_POLISCY	political_science
consumer_class_ANTHRO	anthropology
neoclassical_liberalism_POLISCY	political_science
keynesian_cross_ECON	economics
authoritarian_left_POLISCY	political_science
medical_anthropology_ANTHRO	anthropology
accelerator_effect_ECON	economics
biology_and_political_orientation_POLISCY	political_science
situationist_international_POLISCY	political_science
homo_economicus_ECON	economics
timeline_of_psychology_PSY	psychology
cultural_nationalism_ANTHRO	anthropology
abnormal_psychology_PSY	psychology
enemy_of_the_people_(albania)_POLISCY	political_science
schadenfreude_PSY	psychology
great_power_POLISCY	political_science
service_economy_ECON	economics
labour_voucher_POLISCY	political_science
marxist_sociology_SOC	sociology
surplus_labour_ECON	economics
pathognomy_PSY	psychology
dependent_territory_POLISCY	political_science
authoritarian_democracy_POLISCY	political_science
polyarchy_POLISCY	political_science
high_culture_ANTHRO	anthropology
night-watchman_state_POLISCY	political_science
list_of_sociologists_SOC	sociology
giffen_good_ECON	economics
sustainable_energy_SOC	sociology
ecoauthoritarianism_POLISCY	political_science
ethnomedicine_ANTHRO	anthropology
bibliography_of_works_about_communism_POLISCY	political_science
catch-22_POLISCY	political_science
revolutions_of_1989_POLISCY	political_science
richard_dawkins_PSY	psychology
evolutionary_game_theory_ECON	economics
first_world_ECON	economics
outline_of_culture_ANTHRO	anthropology
intergovernmentalism_POLISCY	political_science
history_of_microeconomics_ECON	economics
identity_(social_science)_SOC	sociology
human_development_index_ECON	economics
regional_power_POLISCY	political_science
history_of_democratic_socialism_POLISCY	political_science
party_system_POLISCY	political_science
economic_indicator_ECON	economics
social_policy_POLISCY	political_science
peasant_ANTHRO	anthropology
serfdom_ANTHRO	anthropology
nutritional_anthropology_ANTHRO	anthropology
paul_romer_ECON	economics
eating_disorder_PSY	psychology
ethnoarchaeology_ANTHRO	anthropology
hardline_POLISCY	political_science
privatism_ECON	economics
solow–swan_model_ECON	economics
social_order_SOC	sociology
cultural_mapping_ANTHRO	anthropology
religious_socialism_POLISCY	political_science
decolonization_POLISCY	political_science
feminist_anthropology_ANTHRO	anthropology
outline_of_thought_PSY	psychology
myron_scholes_ECON	economics
trygve_haavelmo_ECON	economics
list_of_national_legal_systems_POLISCY	political_science
99ers_ECON	economics
blanquism_POLISCY	political_science
left–right_political_spectrum_POLISCY	political_science
arrow's_impossibility_theorem_ECON	economics
cognitive_bias_PSY	psychology
modernity_SOC	sociology
c._d._broad_POLISCY	political_science
altered_state_of_consciousness_PSY	psychology
national_communism_POLISCY	political_science
consumer_debt_ECON	economics
peer_pressure_SOC	sociology
civil_service_POLISCY	political_science
anthropology_of_art_ANTHRO	anthropology
bengt_holmström_ECON	economics
eugene_fama_ECON	economics
enlightened_absolutism_POLISCY	political_science
david_chalmers_PSY	psychology
upper_class_ANTHRO	anthropology
cultural_memory_ANTHRO	anthropology
appeasement_POLISCY	political_science
critical_security_studies_POLISCY	political_science
is–lm_model_ECON	economics
institution_POLISCY	political_science
british_psychotherapy_foundation_PSY	psychology
emotional_reasoning_PSY	psychology
health_policy_POLISCY	political_science
natural_capital_SOC	sociology
scientocracy_POLISCY	political_science
microgeneration_POLISCY	political_science
communal_reinforcement_SOC	sociology
corporate_republic_POLISCY	political_science
john_harsanyi_ECON	economics
ethnomuseology_ANTHRO	anthropology
urban_legend_POLISCY	political_science
ramsey–cass–koopmans_model_ECON	economics
commanding_heights_of_the_economy_POLISCY	political_science
ethnozoology_ANTHRO	anthropology
list_of_social_democratic_parties_POLISCY	political_science
the_protestant_ethic_and_the_spirit_of_capitalism_SOC	sociology
neuroanthropology_ANTHRO	anthropology
scare_SOC	sociology
cultural_radicalism_ANTHRO	anthropology
transnational_progressivism_POLISCY	political_science
business_magnate_ANTHRO	anthropology
gestalt_psychology_PSY	psychology
e-government_POLISCY	political_science
peace_and_conflict_studies_POLISCY	political_science
world_values_survey_POLISCY	political_science
daniel_mcfadden_ECON	economics
majoritarianism_POLISCY	political_science
equality_before_the_law_POLISCY	political_science
least_developed_countries_ECON	economics
major_depressive_disorder_PSY	psychology
psychogeography_ANTHRO	anthropology
preconscious_PSY	psychology
national_conservatism_POLISCY	political_science
list_of_important_publications_in_economics_ECON	economics
transpersonal_psychology_PSY	psychology
edinburgh_university_socialist_society_POLISCY	political_science
horseshoe_theory_POLISCY	political_science
asch_conformity_experiments_PSY	psychology
mudsill_theory_SOC	sociology
particracy_POLISCY	political_science
consensus_democracy_POLISCY	political_science
social_integration_SOC	sociology
welfare_culture_ANTHRO	anthropology
arbitrage_pricing_theory_ECON	economics
attention_economy_SOC	sociology
self-criticism_PSY	psychology
social_conservatism_POLISCY	political_science
structural_violence_SOC	sociology
awareness_PSY	psychology
poverty_class_ANTHRO	anthropology
modern_liberalism_in_the_united_states_POLISCY	political_science
moral_emotions_PSY	psychology
ethnosymbolism_POLISCY	political_science
eco-capitalism_ECON	economics
personhood_POLISCY	political_science
equality_of_outcome_POLISCY	political_science
debate_POLISCY	political_science
ethnic_religion_ANTHRO	anthropology
id,_ego_and_super-ego_PSY	psychology
time_series_ECON	economics
history_of_capitalist_theory_ECON	economics
culturgen_SOC	sociology
science_diplomacy_POLISCY	political_science
occupational_health_psychology_PSY	psychology
political_communication_POLISCY	political_science
information_economics_ECON	economics
list_of_left-wing_internationals_POLISCY	political_science
online_ethnography_ANTHRO	anthropology
production_for_profit_ECON	economics
market_trend_ECON	economics
conservative_liberalism_POLISCY	political_science
econophysics_ECON	economics
slogan_POLISCY	political_science
antimilitarism_POLISCY	political_science
white_power_music_POLISCY	political_science
philosophical_analysis_PSY	psychology
perestroika_POLISCY	political_science
development_anthropology_ANTHRO	anthropology
global_justice_movement_POLISCY	political_science
biosocial_criminology_PSY	psychology
opinion_poll_POLISCY	political_science
mania_PSY	psychology
kshatriya_ANTHRO	anthropology
economics_of_science_ECON	economics
value_product_ECON	economics
civilization_state_POLISCY	political_science
history_of_social_democracy_POLISCY	political_science
security_studies_POLISCY	political_science
affect_(psychology)_PSY	psychology
substitution_effect_ECON	economics
appropriate_technology_POLISCY	political_science
transcultural_nursing_ANTHRO	anthropology
constitutional_economics_POLISCY	political_science
psychohistory_PSY	psychology
cultural_practice_ANTHRO	anthropology
philosophy,_theology,_and_fundamental_theory_of_catholic_canon_law_POLISCY	political_science
visible_hand_(economics)_ECON	economics
social_actions_SOC	sociology
public_policy_doctrine_POLISCY	political_science
culture_hero_ANTHRO	anthropology
constitutional_dictatorship_POLISCY	political_science
clientelism_POLISCY	political_science
bioculture_SOC	sociology
international_sociological_association_SOC	sociology
henri_poincaré_PSY	psychology
bertrand_paradox_(economics)_ECON	economics
nation-building_POLISCY	political_science
blood_and_soil_POLISCY	political_science
rage_(emotion)_PSY	psychology
legalism_(chinese_philosophy)_POLISCY	political_science
barracks_communism_POLISCY	political_science
history_of_propaganda_POLISCY	political_science
left-wing_populism_POLISCY	political_science
ideal_type_SOC	sociology
marginal_rate_of_substitution_ECON	economics
people_power_SOC	sociology
social_cost_ECON	economics
donor_class_ANTHRO	anthropology
collective_mental_state_SOC	sociology
nolan_chart_POLISCY	political_science
isaiah_berlin_POLISCY	political_science
warrior_ANTHRO	anthropology
acceptance_and_commitment_therapy_PSY	psychology
ferdinand_de_saussure_PSY	psychology
wedding_ANTHRO	anthropology
proletarian_nation_POLISCY	political_science
index_(economics)_ECON	economics
bibliography_of_anthropology_ANTHRO	anthropology
manorialism_ANTHRO	anthropology
zooarchaeology_ANTHRO	anthropology
voluntary_society_POLISCY	political_science
history_of_anthropometry_ANTHRO	anthropology
secession_POLISCY	political_science
religious_communism_POLISCY	political_science
non-governmental_organization_POLISCY	political_science
steven_n._s._cheung_ECON	economics
neurophilosophy_PSY	psychology
interactionism_SOC	sociology
task_force_PSY	psychology
capitalist_peace_POLISCY	political_science
linguistic_anthropology_ANTHRO	anthropology
people's_democracy_(marxism–leninism)_POLISCY	political_science
outline_of_anarchism_POLISCY	political_science
cournot_competition_ECON	economics
philosophy_of_sex_PSY	psychology
bibliography_of_sociology_SOC	sociology
ethnoichthyology_ANTHRO	anthropology
mapping_controversies_SOC	sociology
double_hermeneutic_SOC	sociology
regulation_of_science_POLISCY	political_science
structuration_theory_SOC	sociology
paleoanthropology_ANTHRO	anthropology
free_migration_POLISCY	political_science
indifference_curve_ECON	economics
sex_and_gender_distinction_SOC	sociology
mediumship_PSY	psychology
medicalization_SOC	sociology
the_road_to_serfdom_ECON	economics
ernest_jones_PSY	psychology
emotions_in_virtual_communication_PSY	psychology
anglo-saxon_model_POLISCY	political_science
social_degeneration_PSY	psychology
social_model_of_disability_SOC	sociology
organizational_theory_SOC	sociology
linguistic_relativity_ANTHRO	anthropology
emotional_selection_PSY	psychology
list_of_psychological_schools_PSY	psychology
international_energy_agency_POLISCY	political_science
appraisal_theory_PSY	psychology
organicism_POLISCY	political_science
identity_(philosophy)_PSY	psychology
cultural_group_selection_ANTHRO	anthropology
stimulation_PSY	psychology
promiscuity_ANTHRO	anthropology
corporatization_POLISCY	political_science
price_index_ECON	economics
anthony_downs_POLISCY	political_science
equity_premium_puzzle_ECON	economics
filter_bubble_POLISCY	political_science
sociotechnology_SOC	sociology
international_security_POLISCY	political_science
universal_basic_income_POLISCY	political_science
blacklisting_SOC	sociology
international_ethics_POLISCY	political_science
influence_of_mass_media_POLISCY	political_science
out-of-body_experience_PSY	psychology
psychological_trauma_PSY	psychology
community-supported_agriculture_ECON	economics
plurinationalism_POLISCY	political_science
superpower_collapse_POLISCY	political_science
abilene_paradox_PSY	psychology
detection_theory_PSY	psychology
normalization_process_theory_SOC	sociology
christian_fascism_POLISCY	political_science
lawrence_summers_ECON	economics
shadow_(psychology)_PSY	psychology
object_relations_theory_PSY	psychology
economic_nationalism_ECON	economics
list_of_schools_of_psychoanalysis_PSY	psychology
the_great_transformation_(book)_POLISCY	political_science
music_psychology_PSY	psychology
cognitive_anthropology_ANTHRO	anthropology
history_of_science_policy_POLISCY	political_science
werturteilsstreit_SOC	sociology
anti-gender_movement_SOC	sociology
michael_spence_ECON	economics
clive_granger_ECON	economics
statistical_inference_PSY	psychology
rate_of_return_ECON	economics
netnography_ANTHRO	anthropology
iron_cage_SOC	sociology
market_anomaly_ECON	economics
social_reproduction_SOC	sociology
world_economy_ECON	economics
structure_and_agency_SOC	sociology
attachment_parenting_PSY	psychology
collaboration_POLISCY	political_science
virtue_jurisprudence_POLISCY	political_science
schelling's_segregation_model_ECON	economics
technical_change_ECON	economics
petition_of_right_POLISCY	political_science
schar_school_of_policy_and_government_POLISCY	political_science
heritage_commodification_ANTHRO	anthropology
stein_rokkan_POLISCY	political_science
princeton_school_of_public_and_international_affairs_POLISCY	political_science
list_of_mental_disorders_PSY	psychology
list_of_cognitive_biases_PSY	psychology
theory_of_language_ANTHRO	anthropology
self-awareness_PSY	psychology
small_government_POLISCY	political_science
executive_order_POLISCY	political_science
list_of_sociology_journals_SOC	sociology
islamic_sexual_jurisprudence_POLISCY	political_science
sonnenschein–mantel–debreu_theorem_ECON	economics
military_policy_POLISCY	political_science
biology_and_sexual_orientation_ANTHRO	anthropology
socialist_realism_POLISCY	political_science
carl_joachim_friedrich_POLISCY	political_science
levitation_(paranormal)_PSY	psychology
adlerian_PSY	psychology
in_kind_ECON	economics
christian_privilege_POLISCY	political_science
bertrand_competition_ECON	economics
status_group_ANTHRO	anthropology
liberalism_and_conservatism_in_latin_america_POLISCY	political_science
unitarian_universalism_PSY	psychology
subconscious_PSY	psychology
kalergi_plan_POLISCY	political_science
resource_curse_ECON	economics
labor_theory_of_property_POLISCY	political_science
risk_premium_ECON	economics
sequential_game_ECON	economics
urban_metabolism_SOC	sociology
freedom_of_contract_POLISCY	political_science
implicit_cost_ECON	economics
osteology_ANTHRO	anthropology
feminist_legal_theory_POLISCY	political_science
demand_curve_ECON	economics
intelligence_quotient_PSY	psychology
paradox_of_thrift_ECON	economics
legal_naturalism_POLISCY	political_science
führer_POLISCY	political_science
neo-capitalism_ECON	economics
autogenic_training_PSY	psychology
greenwashing_SOC	sociology
dictablanda_POLISCY	political_science
intertemporal_choice_ECON	economics
communism_and_lgbt_rights_POLISCY	political_science
underclass_ANTHRO	anthropology
chaining_PSY	psychology
androcentrism_ANTHRO	anthropology
soft_despotism_POLISCY	political_science
impeachment_SOC	sociology
persistent_vegetative_state_PSY	psychology
shell_money_ANTHRO	anthropology
collective_effervescence_SOC	sociology
bric_ECON	economics
ceteris_paribus_ECON	economics
bush_school_of_government_and_public_service_POLISCY	political_science
race_and_intelligence_ANTHRO	anthropology
global_politics_POLISCY	political_science
life_chances_SOC	sociology
nanook_of_the_north_ANTHRO	anthropology
inframarginal_analysis_ECON	economics
reciprocity_(cultural_anthropology)_ANTHRO	anthropology
afrobarometer_POLISCY	political_science
list_of_public_works_ministries_POLISCY	political_science
mortido_PSY	psychology
social_dominance_orientation_PSY	psychology
composite_index_of_national_capability_POLISCY	political_science
sunk_cost_PSY	psychology
women-are-wonderful_effect_PSY	psychology
reflexivity_(social_theory)_SOC	sociology
self-deception_PSY	psychology
social_cognition_and_interaction_training_PSY	psychology
linguistic_description_ANTHRO	anthropology
economic_transformation_ECON	economics
aion:_researches_into_the_phenomenology_of_the_self_PSY	psychology
emotivism_PSY	psychology
cycle_of_poverty_ECON	economics
big_push_model_ECON	economics
queer_ecology_SOC	sociology
history_of_the_american_legal_profession_POLISCY	political_science
fei–ranis_model_of_economic_growth_ECON	economics
behavioralism_POLISCY	political_science
eco-nationalism_POLISCY	political_science
obscurantism_SOC	sociology
history_of_the_legal_profession_POLISCY	political_science
list_of_psychology_organizations_PSY	psychology
cognitivism_(psychology)_PSY	psychology
anhedonia_PSY	psychology
complex_adaptive_system_SOC	sociology
blue_economy_ECON	economics
performance_PSY	psychology
political_studies_association_POLISCY	political_science
network_effect_ECON	economics
shock_value_PSY	psychology
solitary_confinement_PSY	psychology
vertical_mobility_SOC	sociology
defence_mechanism_PSY	psychology
spatial_politics_POLISCY	political_science
outline_of_globalization_SOC	sociology
tripartite_classification_of_authority_SOC	sociology
violent_non-state_actor_POLISCY	political_science
matrilocal_residence_ANTHRO	anthropology
koteka_ANTHRO	anthropology
manifest_and_latent_functions_and_dysfunctions_SOC	sociology
convergence_(economics)_ECON	economics
person_ANTHRO	anthropology
predictive_policing_POLISCY	political_science
survey_data_collection_POLISCY	political_science
sociology_of_punishment_SOC	sociology
peasant_economics_ECON	economics
georg_weizsäcker_ECON	economics
law_of_rent_ECON	economics
nava_ashraf_ECON	economics
eurosphere_POLISCY	political_science
european_sociological_association_SOC	sociology
law_of_supply_ECON	economics
scientific_man_versus_power_politics_POLISCY	political_science
community_policing_POLISCY	political_science
medical_sociologist_SOC	sociology
ressentiment_SOC	sociology
gaia_philosophy_ANTHRO	anthropology
voter_turnout_POLISCY	political_science
madhhab_POLISCY	political_science
political_repression_POLISCY	political_science
institutionalist_political_economy_POLISCY	political_science
performativity_SOC	sociology
mahr_POLISCY	political_science
seasonal_affective_disorder_PSY	psychology
index_of_sociopolitical_thinkers_SOC	sociology
bumiputera_(malaysia)_ANTHRO	anthropology
primary_market_ECON	economics
sociology_in_poland_SOC	sociology
democratic_globalization_POLISCY	political_science
master_of_public_policy_POLISCY	political_science
social_corporatism_POLISCY	political_science
early_modern_human_ANTHRO	anthropology
growth_stock_ECON	economics
john_roemer_ECON	economics
exequatur_POLISCY	political_science
dark_figure_of_crime_POLISCY	political_science
idealism_in_international_relations_POLISCY	political_science
on_narcissism_PSY	psychology
balkanization_POLISCY	political_science
heckscher–ohlin_model_ECON	economics
global_citizenship_POLISCY	political_science
development_geography_ANTHRO	anthropology
the_birth_of_biopolitics_POLISCY	political_science
dysthymia_PSY	psychology
economic_power_ECON	economics
indian_sociological_society_SOC	sociology
gustave_le_bon_PSY	psychology
hong_kong_college_of_psychiatrists_PSY	psychology
catharsis_PSY	psychology
homosexual_behavior_in_animals_ANTHRO	anthropology
automatic_writing_PSY	psychology
confucian_classes_ANTHRO	anthropology
behaviour_therapy_PSY	psychology
school_of_international_and_public_affairs,_columbia_university_POLISCY	political_science
social_organization_SOC	sociology
william_a._niskanen_POLISCY	political_science
list_of_psychological_research_methods_PSY	psychology
cogito,_ergo_sum_PSY	psychology
flashback_(psychology)_PSY	psychology
action_theory_(sociology)_SOC	sociology
philip_converse_POLISCY	political_science
broken_windows_theory_POLISCY	political_science
two-level_game_theory_POLISCY	political_science
total_survey_error_POLISCY	political_science
openness_SOC	sociology
list_of_unsolved_problems_in_economics_ECON	economics
open_economy_ECON	economics
science_as_a_vocation_SOC	sociology
ethnoornithology_ANTHRO	anthropology
mad_pride_PSY	psychology
ak_model_ECON	economics
nomadic_pastoralism_ANTHRO	anthropology
sanford_school_of_public_policy_POLISCY	political_science
dyad_(sociology)_SOC	sociology
comparative_study_of_electoral_systems_POLISCY	political_science
public_opinion_quarterly_POLISCY	political_science
least-cost_theory_ECON	economics
magnate_ANTHRO	anthropology
roman_agrarian_history_and_its_significance_for_public_and_private_law_SOC	sociology
political_groups_of_the_european_parliament_POLISCY	political_science
white_paper_POLISCY	political_science
neosocialism_POLISCY	political_science
hermann_lotze_PSY	psychology
systems_theory_in_political_science_POLISCY	political_science
social_media_use_in_politics_POLISCY	political_science
gun_control_POLISCY	political_science
maternalism_POLISCY	political_science
international_political_science_association_POLISCY	political_science
frankfurt_declaration_POLISCY	political_science
ronen_palan_POLISCY	political_science
coma_PSY	psychology
zombie_liberalism_POLISCY	political_science
arthur_evans_ANTHRO	anthropology
minangkabau_people_ANTHRO	anthropology
import_substitution_industrialization_ECON	economics
galician_student_league_POLISCY	political_science
atlanticism_POLISCY	political_science
journal_of_the_european_economic_association_ECON	economics
michael_albert_ECON	economics
comparative_historical_research_SOC	sociology
master_of_public_administration_POLISCY	political_science
an_anarchist_faq_POLISCY	political_science
microsociology_SOC	sociology
critical_medical_anthropology_ANTHRO	anthropology
glory_to_hong_kong_POLISCY	political_science
median_voter_theorem_POLISCY	political_science
black–derman–toy_model_ECON	economics
postmodernist_anthropology_ANTHRO	anthropology
american_recovery_and_reinvestment_act_of_2009_POLISCY	political_science
museum_of_mankind_ANTHRO	anthropology
triangular_diplomacy_POLISCY	political_science
blavatnik_school_of_government_POLISCY	political_science
interpersonal_neurobiology_PSY	psychology
non-representational_theory_ANTHRO	anthropology
friendly_fascism_(book)_SOC	sociology
list_of_psychiatric_medications_by_condition_treated_PSY	psychology
rebound_effect_(conservation)_ECON	economics
inner_peace_PSY	psychology
auditory_hallucination_PSY	psychology
agency_(sociology)_SOC	sociology
st._petersburg_paradox_ECON	economics
list_of_psychology_awards_PSY	psychology
peter_sloterdijk_ANTHRO	anthropology
cyberocracy_POLISCY	political_science
value-added_theory_SOC	sociology
dsm-iv_codes_PSY	psychology
asabiyyah_SOC	sociology
semiotic_anthropology_ANTHRO	anthropology
the_rich_get_richer_and_the_poor_get_poorer_ECON	economics
list_of_matrilineal_or_matrilocal_societies_ANTHRO	anthropology
perpetual_war_POLISCY	political_science
economic_mobility_ANTHRO	anthropology
zur_geschichte_der_handelsgesellschaften_im_mittelalter_ECON	economics
law_of_increasing_costs_ECON	economics
computational_sociology_SOC	sociology
histrionic_personality_disorder_PSY	psychology
sedentism_ANTHRO	anthropology
destabilisation_PSY	psychology
sociology_of_the_world_religions_SOC	sociology
hierarchical_organization_POLISCY	political_science
metcalfe's_law_ECON	economics
pippa_norris_POLISCY	political_science
ethnolichenology_ANTHRO	anthropology
proto-industrialization_ECON	economics
gary_l._francione_POLISCY	political_science
list_of_financial_economists_ECON	economics
henry_e._brady_POLISCY	political_science
recuperation_(politics)_SOC	sociology
campaign_finance_POLISCY	political_science
leonid_kantorovich_ECON	economics
civilization_in_transition_PSY	psychology
preselection_POLISCY	political_science
eurasianism_POLISCY	political_science
feoffment_POLISCY	political_science
hiding_hand_principle_ECON	economics
personal_life_ANTHRO	anthropology
jus_commune_POLISCY	political_science
john_beddoe_ANTHRO	anthropology
inquisitorial_system_POLISCY	political_science
vacatio_legis_POLISCY	political_science
democratic_liberalism_POLISCY	political_science
béla_h._bánáthy_SOC	sociology
nǃai,_the_story_of_a_ǃkung_woman_ANTHRO	anthropology
heavily_indebted_poor_countries_ECON	economics
marie-louise_von_franz_PSY	psychology
instituts_d'études_politiques_POLISCY	political_science
forward_price_ECON	economics
gender_essentialism_SOC	sociology
cost_of_electricity_by_source_ECON	economics
helen_margetts_POLISCY	political_science
theatre_state_ANTHRO	anthropology
high_and_low_politics_POLISCY	political_science
peace_journalism_POLISCY	political_science
franz_oppenheimer_SOC	sociology
international_sanctions_POLISCY	political_science
popular_socialism_POLISCY	political_science
credit_default_option_ECON	economics
bananas,_beaches_and_bases_POLISCY	political_science
david_laidler_ECON	economics
renewable_energy_transition_POLISCY	political_science
global_workspace_theory_PSY	psychology
german_university_of_administrative_sciences_speyer_POLISCY	political_science
communications_management_POLISCY	political_science
relational_sociology_SOC	sociology
binomial_options_pricing_model_ECON	economics
momentum_(finance)_ECON	economics
marginal_propensity_to_consume_ECON	economics
sinodonty_and_sundadonty_ANTHRO	anthropology
security,_territory,_population_POLISCY	political_science
honeymoon_ANTHRO	anthropology
possible_world_ANTHRO	anthropology
erguer-estudantes_da_galiza_POLISCY	political_science
voting_rights_in_the_united_states_POLISCY	political_science
civic_political_culture_POLISCY	political_science
society_for_medical_anthropology_ANTHRO	anthropology
human_ethology_ANTHRO	anthropology
xeira_SOC	sociology
organizational_space_SOC	sociology
regionalism_(international_relations)_POLISCY	political_science
bicameral_mentality_PSY	psychology
quantitative_psychological_research_PSY	psychology
pickens_plan_POLISCY	political_science
medical_psychology_PSY	psychology
otto_kirchheimer_POLISCY	political_science
crazy_therapies_PSY	psychology
radical_psychology_network_PSY	psychology
discrimination_against_autistic_people_SOC	sociology
bolivarian_revolution_POLISCY	political_science
social_conflict_SOC	sociology
air_rights_SOC	sociology
conditioned_emotional_response_PSY	psychology
mindfreedom_international_PSY	psychology
structural_discrimination_SOC	sociology
sascha_altman_dubrul_PSY	psychology
political_studies_review_POLISCY	political_science
fourteen_words_POLISCY	political_science
robinson_crusoe_economy_ECON	economics
list_of_years_in_anthropology_ANTHRO	anthropology
united_nations_parliamentary_assembly_POLISCY	political_science
ilminism_POLISCY	political_science
westphalian_sovereignty_POLISCY	political_science
anthropology_of_institutions_ANTHRO	anthropology
synarchism_POLISCY	political_science
visible_minority_SOC	sociology
standard_cross-cultural_sample_ANTHRO	anthropology
foreign_agricultural_service_ECON	economics
ecomodernism_SOC	sociology
psycho-oncology_PSY	psychology
discouraged_worker_ECON	economics
average_joe_SOC	sociology
futarchy_POLISCY	political_science
el_pueblo_unido_jamás_será_vencido_POLISCY	political_science
public_property_ECON	economics
fabrizio_zilibotti_ECON	economics
risk_factor_(finance)_ECON	economics
swanson,_nolan_and_pelham_teacher_and_parent_rating_scale_PSY	psychology
pit_of_despair_PSY	psychology
dark_triad_PSY	psychology
technoliberalism_POLISCY	political_science
womyn's_land_ANTHRO	anthropology
non-sampling_error_POLISCY	political_science
bay'ah_POLISCY	political_science
list_of_mammals_displaying_homosexual_behavior_ANTHRO	anthropology
imperium_POLISCY	political_science
doji_ECON	economics
donchian_channel_ECON	economics
list_of_birds_displaying_homosexual_behavior_ANTHRO	anthropology
managerialism_POLISCY	political_science
family_disruption_SOC	sociology
walter_f._dodd_POLISCY	political_science
coverage_error_POLISCY	political_science
neoauthoritarianism_(china)_POLISCY	political_science
female_promiscuity_ANTHRO	anthropology
ecocide_POLISCY	political_science
american_university_school_of_international_service_POLISCY	political_science
injustice_SOC	sociology
serer_people_ANTHRO	anthropology
ahl_al-hadith_POLISCY	political_science
answer_to_job_PSY	psychology
edgeworth_binomial_tree_ECON	economics
paleopathology_ANTHRO	anthropology
crypto-communism_POLISCY	political_science
circumscription_theory_ANTHRO	anthropology
consumer_sovereignty_POLISCY	political_science
public_opinion_on_climate_change_POLISCY	political_science
comunismo_a_la_tica_POLISCY	political_science
forensic_facial_reconstruction_ANTHRO	anthropology
cash_crop_ECON	economics
autonomous_communities_of_spain_POLISCY	political_science
classical_realism_(international_relations)_POLISCY	political_science
grave_goods_ANTHRO	anthropology
mourning_and_melancholia_PSY	psychology
classical_test_theory_PSY	psychology
f._g._bailey_ANTHRO	anthropology
autonomous_consumption_ECON	economics
postinternationalism_POLISCY	political_science
age_set_ANTHRO	anthropology
bipolar_i_disorder_PSY	psychology
patrilocal_residence_ANTHRO	anthropology
alchemical_studies_PSY	psychology
research_papers_in_economics_ECON	economics
wedding_vow_renewal_ceremony_ANTHRO	anthropology
2000-watt_society_POLISCY	political_science
johnson_cult_POLISCY	political_science
history_of_psychotherapy_PSY	psychology
hunting_hypothesis_ANTHRO	anthropology
corporative_federalism_POLISCY	political_science
relative_gain_(international_relations)_POLISCY	political_science
moral_entrepreneur_SOC	sociology
negroid_ANTHRO	anthropology
collective_memory_SOC	sociology
repertory_grid_PSY	psychology
contemplation_PSY	psychology
coal_phase-out_POLISCY	political_science
excess_burden_of_taxation_ECON	economics
media_circus_POLISCY	political_science
ecological_psychology_PSY	psychology
eonia_ECON	economics
creativity_and_mental_health_PSY	psychology
list_of_neurological_conditions_and_disorders_PSY	psychology
leontief_paradox_ECON	economics
leveling_mechanism_ANTHRO	anthropology
group_threat_theory_SOC	sociology
human_behavioral_ecology_ANTHRO	anthropology
samuel_von_pufendorf_ECON	economics
basket_of_deplorables_POLISCY	political_science
helene_deutsch_PSY	psychology
failed_state_POLISCY	political_science
list_of_visual_anthropology_films_ANTHRO	anthropology
nations_and_iq_ANTHRO	anthropology
typology_(anthropology)_ANTHRO	anthropology
bertil_lundman_ANTHRO	anthropology
commodity_credit_corporation_ECON	economics
gar_alperovitz_POLISCY	political_science
biophilia_hypothesis_PSY	psychology
the_american_journal_of_economics_and_sociology_SOC	sociology
multi-level_governance_POLISCY	political_science
role_ethics_POLISCY	political_science
extended-hours_trading_ECON	economics
figurational_sociology_SOC	sociology
nur_für_deutsche_POLISCY	political_science
circular_flow_of_income_ECON	economics
computational_theory_of_mind_PSY	psychology
list_of_psychiatric_medications_PSY	psychology
names_for_the_human_species_ANTHRO	anthropology
martial_race_ANTHRO	anthropology
elhanan_helpman_ECON	economics
grazing_rights_POLISCY	political_science
ecolabel_SOC	sociology
post-truth_politics_POLISCY	political_science
antemurale_myth_POLISCY	political_science
american_association_for_the_abolition_of_involuntary_mental_hospitalization_PSY	psychology
lorenz_curve_ECON	economics
national_average_salary_ECON	economics
global_terrorism_index_POLISCY	political_science
business_oligarch_POLISCY	political_science
post-behavioralism_POLISCY	political_science
caudillo_POLISCY	political_science
robert_m._la_follette_school_of_public_affairs_POLISCY	political_science
time_value_of_money_ECON	economics
consummation_ANTHRO	anthropology
frente_despertar_POLISCY	political_science
roll-geske-whaley_ECON	economics
nominal_yield_ECON	economics
siobhan_o'sullivan_POLISCY	political_science
philosophy_of_max_stirner_SOC	sociology
i-spread_ECON	economics
liberal_corporatism_POLISCY	political_science
reproduction_(economics)_ECON	economics
material_flow_analysis_SOC	sociology
revealed_preference_POLISCY	political_science
political_risk_ECON	economics
proto-malay_ANTHRO	anthropology
parliamentary_debate_POLISCY	political_science
perpetual_bond_ECON	economics
gish_gallop_POLISCY	political_science
demonizing_the_enemy_POLISCY	political_science
murray's_hypocycloidal_engine_ECON	economics
total_institution_SOC	sociology
note_verbale_POLISCY	political_science
crimes_against_humanity_under_communist_regimes_POLISCY	political_science
bankocracy_POLISCY	political_science
blue_labour_POLISCY	political_science
animal_testing_regulations_POLISCY	political_science
concurrent_powers_POLISCY	political_science
trobriand_islands_ANTHRO	anthropology
balassa–samuelson_effect_ECON	economics
social_phenomenon_SOC	sociology
population_health_ANTHRO	anthropology
per_capita_personal_income_in_the_united_states_ECON	economics
tactical_voting_POLISCY	political_science
chargé_de_mission_POLISCY	political_science
emmette_redford_POLISCY	political_science
code_of_hammurabi_POLISCY	political_science
full_spectrum_diplomacy_POLISCY	political_science
induced_consumption_ECON	economics
social_invisibility_SOC	sociology
assortative_mixing_SOC	sociology
communist_era_POLISCY	political_science
warren_miller_(political_scientist)_POLISCY	political_science
entitlement_SOC	sociology
structural_endogamy_ANTHRO	anthropology
islamic_toilet_etiquette_POLISCY	political_science
food_processing_ECON	economics
theories_of_poverty_ECON	economics
koestler_parapsychology_unit_PSY	psychology
responsibility_SOC	sociology
prohibition_of_dying_POLISCY	political_science
econtalk_ECON	economics
women_who_have_sex_with_women_ANTHRO	anthropology
necropolitics_SOC	sociology
robert_heilbroner_ECON	economics
facial_expression_PSY	psychology
islam_and_children_POLISCY	political_science
early_social_changes_under_islam_POLISCY	political_science
global_apartheid_POLISCY	political_science
human_genetic_variation_ANTHRO	anthropology
cooper_do-nuts_riot_SOC	sociology
recent_human_evolution_ANTHRO	anthropology
edvard_westermarck_ANTHRO	anthropology
human_universals_ANTHRO	anthropology
green_job_ECON	economics
home_rule_POLISCY	political_science
elihu_katz_SOC	sociology
give_peace_a_chance_POLISCY	political_science
instrumental_and_value-rational_action_SOC	sociology
edgeworth_paradox_ECON	economics
value_judgment_SOC	sociology
worldwide_influence_of_the_constitution_of_the_united_states_POLISCY	political_science
theory_of_change_SOC	sociology
sociology_of_morality_SOC	sociology
agency_(philosophy)_SOC	sociology
timeline_of_psychotherapy_PSY	psychology
philosophy_of_life_ANTHRO	anthropology
implied_powers_POLISCY	political_science
deliberation_POLISCY	political_science
metalanguage_ANTHRO	anthropology
white_wedding_ANTHRO	anthropology
peak_wheat_ECON	economics
reflexive_modernization_SOC	sociology
reliability_(statistics)_PSY	psychology
wedding_reception_ANTHRO	anthropology
burmese_way_to_socialism_POLISCY	political_science
constantin_noica_ANTHRO	anthropology
concentrated_disadvantage_SOC	sociology
new_social_movements_SOC	sociology
lady_wonder_PSY	psychology
sociology_in_japan_SOC	sociology
health_geography_ANTHRO	anthropology
ernst_mally_PSY	psychology
control_theory_(sociology)_SOC	sociology
civic_virtue_SOC	sociology
paradox_of_value_ECON	economics
conservative_corporatism_POLISCY	political_science
national_equities_exchange_and_quotations_ECON	economics
emotional_abuse_PSY	psychology
william_frankena_PSY	psychology
symbolic_religiosity_SOC	sociology
gold-collar_worker_ECON	economics
religious_literacy_SOC	sociology
cognitive_archaeology_ANTHRO	anthropology
max_scheler_ANTHRO	anthropology
the_concept_of_anxiety_PSY	psychology
economic_puzzle_ECON	economics
guido_tabellini_ECON	economics
poppet_ANTHRO	anthropology
equity_home_bias_puzzle_ECON	economics
field_theory_(sociology)_SOC	sociology
food_sovereignty_POLISCY	political_science
social_media_use_by_donald_trump_POLISCY	political_science
legitimation_crisis_POLISCY	political_science
argument_from_authority_SOC	sociology
a_green_new_deal_POLISCY	political_science
ricardian_equivalence_ECON	economics
alpha_(finance)_ECON	economics
list_of_environmental_ministries_POLISCY	political_science
fount_of_honour_ANTHRO	anthropology
guns_versus_butter_model_ECON	economics
pitt_rivers_museum_ANTHRO	anthropology
sovereignty_of_puerto_rico_during_the_cold_war_POLISCY	political_science
communist_front_POLISCY	political_science
accuracy_and_precision_PSY	psychology
liberal_international_order_POLISCY	political_science
thawri_POLISCY	political_science
political_culture_of_the_united_states_POLISCY	political_science
christian_corporatism_POLISCY	political_science
proverb_ANTHRO	anthropology
psychonautics_PSY	psychology
pakistan_public_works_department_POLISCY	political_science
awza'i_POLISCY	political_science
lesser_of_two_evils_principle_POLISCY	political_science
quiet_revolution_SOC	sociology
the_independent_review_POLISCY	political_science
robert_f._wagner_graduate_school_of_public_service_POLISCY	political_science
digital_era_governance_POLISCY	political_science
poker_PSY	psychology
responsibility_to_protect_POLISCY	political_science
christian_egalitarianism_POLISCY	political_science
prediction_market_POLISCY	political_science
mandailing_people_ANTHRO	anthropology
marija_gimbutas_ANTHRO	anthropology
democracy-dictatorship_index_POLISCY	political_science
list_of_animals_displaying_homosexual_behavior_ANTHRO	anthropology
strategy_of_tension_POLISCY	political_science
dang_guo_POLISCY	political_science
scottish_index_of_multiple_deprivation_ECON	economics
malikism_in_algeria_POLISCY	political_science
party_platform_POLISCY	political_science
general_semantics_PSY	psychology
nudity_ANTHRO	anthropology
fractional-reserve_banking_ECON	economics
sleep_and_learning_PSY	psychology
superiority_complex_PSY	psychology
cleavage_(politics)_POLISCY	political_science
health_system_POLISCY	political_science
heterosociality_SOC	sociology
list_of_countries_by_inequality-adjusted_income_SOC	sociology
maceration_(bone)_ANTHRO	anthropology
morphological_freedom_SOC	sociology
glossary_of_international_relations_terms_POLISCY	political_science
list_of_countries_by_share_of_income_of_the_richest_one_percent_SOC	sociology
serer-ndut_people_ANTHRO	anthropology
implicit-association_test_PSY	psychology
freud's_seduction_theory_PSY	psychology
hypnopompic_ANTHRO	anthropology
piaget's_theory_of_cognitive_development_PSY	psychology
lingeer_ANTHRO	anthropology
flow_(psychology)_PSY	psychology
men_who_have_sex_with_men_ANTHRO	anthropology
lingeer_ngoné_dièye_ANTHRO	anthropology
civil_discourse_SOC	sociology
pay_it_forward_SOC	sociology
digging_stick_ANTHRO	anthropology
opinion_leadership_POLISCY	political_science
serer_maternal_clans_ANTHRO	anthropology
control_(management)_SOC	sociology
ceremony_ANTHRO	anthropology
radicalization_SOC	sociology
parliamentary_procedure_POLISCY	political_science
reed's_law_ECON	economics
anthropological_index_online_ANTHRO	anthropology
richard_wiseman_PSY	psychology
anthropological_criminology_ANTHRO	anthropology
ratification_POLISCY	political_science
law_and_order_POLISCY	political_science
syed_hayatullah_POLISCY	political_science
center_on_conscience_&_war_SOC	sociology
wakefulness_PSY	psychology
l'année_sociologique_SOC	sociology
production–possibility_frontier_ECON	economics
dynamical_system_ECON	economics
border_control_POLISCY	political_science
australian_aboriginal_kinship_ANTHRO	anthropology
classificatory_kinship_ANTHRO	anthropology
right_to_development_SOC	sociology
autonomous_administrative_division_POLISCY	political_science
diane_bell_(anthropologist)_ANTHRO	anthropology
dispersed_knowledge_ECON	economics
mosuo_women_ANTHRO	anthropology
biocultural_anthropology_ANTHRO	anthropology
decentralized_autonomous_organization_POLISCY	political_science
variable_rate_debt_obligation_ECON	economics
law_of_the_instrument_PSY	psychology
museum_of_archaeology_and_anthropology,_university_of_cambridge_ANTHRO	anthropology
free_market_fairness_POLISCY	political_science
conversational_model_PSY	psychology
kremlinology_POLISCY	political_science
new_left_review_POLISCY	political_science
risk_management_agency_ECON	economics
cobweb_model_ECON	economics
unplanned_economies_ECON	economics
economics_terminology_that_differs_from_common_usage_ECON	economics
social_media_in_the_2016_united_states_presidential_election_POLISCY	political_science
mandeville's_paradox_ECON	economics
burlesque_PSY	psychology
revolutionary_students_federation_POLISCY	political_science
muhammad_taqi_usmani_POLISCY	political_science
diamond-water_paradox_ECON	economics
journal_of_theoretical_politics_POLISCY	political_science
charles_henry_hull_ECON	economics
on_the_principles_of_political_economy_and_taxation_POLISCY	political_science
humanistic_sociology_SOC	sociology
noosphere_PSY	psychology
neo-ricardianism_ECON	economics
economic_stimulus_appropriations_act_of_1977_POLISCY	political_science
weighted_average_cost_of_capital_ECON	economics
plenary_power_POLISCY	political_science
liesbet_hooghe_POLISCY	political_science
economic_data_ECON	economics
direct_and_indirect_realism_PSY	psychology
associationalism_POLISCY	political_science
power-to-x_POLISCY	political_science
net_worth_ECON	economics
carbon_fee_and_dividend_POLISCY	political_science
comités_abertos_de_estudantes_POLISCY	political_science
alan_wolfe_POLISCY	political_science
interprovincial_migration_in_canada_ECON	economics
the_counter-revolution_of_science_ECON	economics
weighted_network_SOC	sociology
corporate_statism_POLISCY	political_science
ipse_dixit_SOC	sociology
james_tully_(philosopher)_POLISCY	political_science
timocracy_POLISCY	political_science
psychological_statistics_PSY	psychology
transformation_processes_(media_systems)_POLISCY	political_science
rent-setting_POLISCY	political_science
american_journal_of_political_science_POLISCY	political_science
galician_workers_union_POLISCY	political_science
hubbert_peak_theory_ECON	economics
grey-zone_(international_relations)_POLISCY	political_science
auction_theory_ECON	economics
sofr_ECON	economics
principles_of_economics_(marshall_book)_ECON	economics
equalization_payments_ECON	economics
list_of_women_anthropologists_ANTHRO	anthropology
woolrich_electrical_generator_ECON	economics
primitivism_ANTHRO	anthropology
tibor_ECON	economics
euronia_ECON	economics
history_of_political_science_POLISCY	political_science
graduate_school_of_public_policy,_university_of_tokyo_POLISCY	political_science
sustainable_business_SOC	sociology
hobby_ANTHRO	anthropology
politico-media_complex_POLISCY	political_science
maladministration_POLISCY	political_science
wood_industry_ECON	economics
australian_journal_of_political_science_POLISCY	political_science
implementation_POLISCY	political_science
celeb_jihad_POLISCY	political_science
one_man,_one_vote_POLISCY	political_science
kurt_koffka_medal_PSY	psychology
concentration_risk_ECON	economics
journal_of_public_economics_ECON	economics
energy_research_&_social_science_SOC	sociology
forward_premium_anomaly_ECON	economics
fight-or-flight_response_PSY	psychology
land_management_ECON	economics
energy_charter_treaty_POLISCY	political_science
jacqueline_rose_PSY	psychology
energy_community_POLISCY	political_science
the_emperor's_new_mind_PSY	psychology
obtundation_PSY	psychology
hypodermic_needle_model_SOC	sociology
notary_(catholic_canon_law)_POLISCY	political_science
comparing_media_systems_POLISCY	political_science
vocabulary_development_PSY	psychology
edward_j._bloustein_school_of_planning_and_public_policy_POLISCY	political_science
excess_reserves_ECON	economics
garden_of_allah_(cabaret)_SOC	sociology
martens_centre_POLISCY	political_science
parochial_political_culture_POLISCY	political_science
ambidexterity_PSY	psychology
list_of_production_functions_ECON	economics
experimental_political_science_POLISCY	political_science
proverbial_phrase_ANTHRO	anthropology
blink:_the_power_of_thinking_without_thinking_PSY	psychology
argument_from_marginal_cases_SOC	sociology
little_albert_experiment_PSY	psychology
two-factor_theory_of_emotion_PSY	psychology
helmuth_plessner_ANTHRO	anthropology
susto_ANTHRO	anthropology
menstruation_in_islam_POLISCY	political_science
environmental_policy_of_the_european_union_POLISCY	political_science
riane_eisler_ANTHRO	anthropology
social_vulnerability_SOC	sociology
pricing_kernel_ECON	economics
counterpropaganda_POLISCY	political_science
alter_ego_PSY	psychology
national_power_POLISCY	political_science
human_terrain_system_ANTHRO	anthropology
pork_barrel_POLISCY	political_science
istihlal_POLISCY	political_science
deflator_ECON	economics
cover-up_PSY	psychology
donatella_della_porta_POLISCY	political_science
peelian_principles_POLISCY	political_science
nurturant_parent_model_POLISCY	political_science
obreption_and_subreption_(catholic_canon_law)_POLISCY	political_science
open_field_(animal_test)_PSY	psychology
population_and_development_review_SOC	sociology
data_collection_system_POLISCY	political_science
erwin_plein_nemmers_prize_in_economics_ECON	economics
microexpression_PSY	psychology
principles_of_political_economy_POLISCY	political_science
behavioural_despair_test_PSY	psychology
mesoeconomics_ECON	economics
psychomotor_retardation_PSY	psychology
fama–french_three-factor_model_ECON	economics
cephalic_index_ANTHRO	anthropology
law_without_the_state_POLISCY	political_science
rogers_brubaker_SOC	sociology
state_price_density_ECON	economics
apuli_ANTHRO	anthropology
globalization_and_women_in_china_SOC	sociology
rumor_POLISCY	political_science
fiscal_policy_of_the_united_states_POLISCY	political_science
essence_of_decision_POLISCY	political_science
decoloniality_POLISCY	political_science
gadsden_flag_POLISCY	political_science
economists_for_peace_and_security_ECON	economics
promulgation_(catholic_canon_law)_POLISCY	political_science
the_hunters_(1957_film)_ANTHRO	anthropology
beckstrom's_law_ECON	economics
custom_(catholic_canon_law)_POLISCY	political_science
private_military_company_POLISCY	political_science
social_patriotism_POLISCY	political_science
sublimation_(psychology)_PSY	psychology
list_of_bordering_countries_with_greatest_relative_differences_in_gdp_(ppp)_per_capita_SOC	sociology
differentiated_bertrand_competition_ECON	economics
trait_ascription_bias_PSY	psychology
dynamicism_PSY	psychology
linguistics_in_science_fiction_ANTHRO	anthropology
hannah_arendt_institute_for_totalitarianism_studies_POLISCY	political_science
causes_of_transsexuality_PSY	psychology
chinese_kinship_ANTHRO	anthropology
kriza_jános_ethnographic_society_ANTHRO	anthropology
muted_group_theory_ANTHRO	anthropology
population_health_policies_and_interventions_ANTHRO	anthropology
schizotypy_PSY	psychology
state_order_POLISCY	political_science
serfdom_in_tibet_controversy_POLISCY	political_science
state_decoration_POLISCY	political_science
unsaid_ANTHRO	anthropology
museo_de_antropología_de_xalapa_ANTHRO	anthropology
hotelling's_law_ECON	economics
gerschenkron_effect_ECON	economics
downs–thomson_paradox_ECON	economics
challengeaccepted_POLISCY	political_science
problem-oriented_policing_POLISCY	political_science
instrumental_and_value_rationality_SOC	sociology
conceptual_economy_ECON	economics
marginal_rate_of_transformation_ECON	economics
the_white_goddess_ANTHRO	anthropology
sexual_inversion_(sexology)_ANTHRO	anthropology
ideocracy_POLISCY	political_science
homo_faber_ANTHRO	anthropology
pattern_recognition_(psychology)_PSY	psychology
aromanian_question_POLISCY	political_science
verbal_behavior_PSY	psychology
ego_integrity_PSY	psychology
a_call_to_action:_women,_religion,_violence,_and_power_POLISCY	political_science
proactive_policing_POLISCY	political_science
emotive_(sociology)_SOC	sociology
jacob_hollander_ECON	economics
models_of_abnormality_PSY	psychology
garveyism_POLISCY	political_science
list_of_futurama_characters_POLISCY	political_science
trash_doves_ANTHRO	anthropology
content_marketing_POLISCY	political_science
the_revolution_of_everyday_life_SOC	sociology
payment_for_ecosystem_services_SOC	sociology
review_of_international_political_economy_POLISCY	political_science
edgeworth_box_ECON	economics
benny_moldovanu_ECON	economics
sociological_naturalism_SOC	sociology
subsidy_POLISCY	political_science
technocracy_movement_ECON	economics
frustration–aggression_hypothesis_PSY	psychology
geography_of_media_and_communication_ANTHRO	anthropology
free-market_healthcare_POLISCY	political_science
social_threefolding_SOC	sociology
norwegian_sociological_association_SOC	sociology
university_of_san_diego_POLISCY	political_science
musée_de_l'homme_ANTHRO	anthropology
scale_analysis_(statistics)_POLISCY	political_science
great_gatsby_curve_ECON	economics
finance_&_development_ECON	economics
scotland's_future_POLISCY	political_science
generosity_SOC	sociology
psychological_nativism_PSY	psychology
asu_college_of_public_service_&_community_solutions_POLISCY	political_science
socialist_campaign_group_POLISCY	political_science
structural_inequality_SOC	sociology
mccourt_school_of_public_policy_POLISCY	political_science
real-world_economics_review_ECON	economics
german_model_POLISCY	political_science
cacique_POLISCY	political_science
green_industrial_policy_POLISCY	political_science
greek_withdrawal_from_the_eurozone_POLISCY	political_science
johann_friedrich_herbart_PSY	psychology
journal_of_democracy_POLISCY	political_science
breakout_(technical_analysis)_ECON	economics
environment_minister_ECON	economics
hanging_man_(candlestick_pattern)_ECON	economics
prickly_paradigm_press_ANTHRO	anthropology
kluet_people_ANTHRO	anthropology
qazi_syed_inayatullah_POLISCY	political_science
european_union_studies_association_POLISCY	political_science
british_journal_of_politics_and_international_relations_POLISCY	political_science
technical_indicator_ECON	economics
development_bureau_POLISCY	political_science
imagery_of_nude_celebrities_SOC	sociology
grenoble_institute_of_political_studies_POLISCY	political_science
chester_barnard_POLISCY	political_science
martin_hellwig_ECON	economics
angkola_people_ANTHRO	anthropology
travel_behavior_ANTHRO	anthropology
live_free_or_die_POLISCY	political_science
the_hebrew_goddess_ANTHRO	anthropology
option_screener_ECON	economics
methodology_of_econometrics_ECON	economics
communication_university_of_china_POLISCY	political_science
nominate_(scaling_method)_POLISCY	political_science
the_journal_of_politics_POLISCY	political_science
national_crime_victimization_survey_POLISCY	political_science
timeline_of_voting_rights_in_the_united_states_POLISCY	political_science
terry_karl_POLISCY	political_science
peace_dividend_POLISCY	political_science
territorialisation_of_carbon_governance_POLISCY	political_science
i_did_not_have_sexual_relations_with_that_woman_POLISCY	political_science
list_of_anthropologists_ANTHRO	anthropology
united_states_farm_bill_ECON	economics
kuznets_curve_ECON	economics
index_of_urban_sociology_articles_SOC	sociology
institut_d'études_politiques_de_toulouse_POLISCY	political_science
olivier_ihl_POLISCY	political_science
karl_deutsch_award_POLISCY	political_science
peso_problem_(finance)_ECON	economics
national_question_(quebec)_POLISCY	political_science
stephanos_bibas_POLISCY	political_science
rent_extraction_POLISCY	political_science
hicks-tinbergen_award_ECON	economics
outline_of_autism_PSY	psychology
dualism_(law)_POLISCY	political_science
fallen_woman_ANTHRO	anthropology
financial_models_with_long-tailed_distributions_and_volatility_clustering_ECON	economics
rentier_state_POLISCY	political_science
ceremonial_pole_ANTHRO	anthropology
cosmopolitan_democracy_POLISCY	political_science
security_studies_(journal)_POLISCY	political_science
crown_servant_POLISCY	political_science
party_identification_POLISCY	political_science
public_morality_SOC	sociology
we_don't_coast_POLISCY	political_science
carl_albert_center_POLISCY	political_science
civility_SOC	sociology
dynamic_pricing_ECON	economics
school_of_political_and_social_sciences,_unam_POLISCY	political_science
garman-kohlhagen_model_ECON	economics
international_council_for_science_POLISCY	political_science
divided_government_in_the_united_states_POLISCY	political_science
discrete_choice_ECON	economics
istván_hont_ECON	economics
pınar_selek_SOC	sociology
open-mindedness_PSY	psychology
institute_for_economics_and_peace_POLISCY	political_science
european_master_of_public_administration_consortium_POLISCY	political_science
xuanchuan_POLISCY	political_science
v-dem_institute_POLISCY	political_science
marco_tarchi_POLISCY	political_science
international_society_of_political_psychology_PSY	psychology
antinaturalism_(politics)_POLISCY	political_science
faculty_of_political_science,_chulalongkorn_university_POLISCY	political_science
fritz_w._scharpf_POLISCY	political_science
real_economy_ECON	economics
chiara_bottici_POLISCY	political_science
self-hypnosis_PSY	psychology
faye_v._harrison_ANTHRO	anthropology
alva_myrdal_SOC	sociology
berkeley_school_of_political_theory_POLISCY	political_science
person_of_color_SOC	sociology
fischer_black_prize_ECON	economics
effective_number_of_parties_POLISCY	political_science
international_political_sociology_(ips)_SOC	sociology
julius_stone_POLISCY	political_science
we_shall_overcome_POLISCY	political_science
the_culture_of_narcissism_SOC	sociology
violent_non-state_actors_at_sea_POLISCY	political_science
contingent_sovereignty_POLISCY	political_science
conjoint_analysis_PSY	psychology
rat_race_ECON	economics
the_triple_revolution_POLISCY	political_science
the_twenty_years'_crisis_POLISCY	political_science
sectoral_balances_ECON	economics
procreative_beneficence_SOC	sociology
joint_attention_PSY	psychology
capital_cost_ECON	economics
topic_and_comment_ANTHRO	anthropology
cat_intelligence_PSY	psychology
austerity:_the_history_of_a_dangerous_idea_ECON	economics
ghazi_(warrior)_ANTHRO	anthropology
china_university_of_political_science_and_law_POLISCY	political_science
returns_(economics)_ECON	economics
liechtenstein_institute_on_self-determination_POLISCY	political_science
high-altitude_adaptation_in_humans_ANTHRO	anthropology
sopor_(sleep)_PSY	psychology
andean_civilizations_ANTHRO	anthropology
norwegian_paradox_ECON	economics
bowley's_law_ECON	economics
déjà_vu_PSY	psychology
soul_dualism_ANTHRO	anthropology
the_soldier_and_the_state_POLISCY	political_science
prenatal_hormones_and_sexual_orientation_ANTHRO	anthropology
urban_revolution_ANTHRO	anthropology
strict_father_model_POLISCY	political_science
non-state_actor_POLISCY	political_science
comprehension_approach_PSY	psychology
laterality_PSY	psychology
low-volatility_anomaly_ECON	economics
raptio_ANTHRO	anthropology
heel–ball_index_ANTHRO	anthropology
taste_(sociology)_SOC	sociology
right_to_exist_POLISCY	political_science
naturalistic_disease_theories_ANTHRO	anthropology
informal_social_control_SOC	sociology
mariya_gabriel_POLISCY	political_science
base_period_ECON	economics
masters_in_agricultural_economics_ECON	economics
an_economic_theory_of_democracy_POLISCY	political_science
rudolf_virchow_award_ANTHRO	anthropology
chua_beng_huat_SOC	sociology
development-supported_agriculture_SOC	sociology
islamic_funeral_POLISCY	political_science
toloy_ANTHRO	anthropology
island_mentality_SOC	sociology
proposed_national_unification_promotion_law_POLISCY	political_science
status_attainment_SOC	sociology
international_centre_for_black_sea_studies_POLISCY	political_science
legal_norm_POLISCY	political_science
political_cartoon_POLISCY	political_science
general_knowledge_PSY	psychology
paradox_of_prosperity_ECON	economics
heterotopia_(space)_ANTHRO	anthropology
psychological_resistance_PSY	psychology
communicative_dynamism_ANTHRO	anthropology
resocialization_SOC	sociology
normalcy_bias_PSY	psychology
sissyphobia:_gay_men_and_effeminate_behavior_SOC	sociology
deep_history_ANTHRO	anthropology
third-person_effect_POLISCY	political_science
blank_expression_PSY	psychology
tractatus_politicus_POLISCY	political_science
international_isolation_POLISCY	political_science
identity_crisis_PSY	psychology
social_transformation_SOC	sociology
skhul_and_qafzeh_hominins_ANTHRO	anthropology
reality_distortion_field_SOC	sociology
fenno's_paradox_POLISCY	political_science
group_action_(sociology)_SOC	sociology
icarus_paradox_ECON	economics
cosmos_and_psyche_PSY	psychology
usul_fiqh_in_ja'fari_school_POLISCY	political_science
meta_learning_PSY	psychology
knowledge_of_the_holocaust_in_nazi_germany_and_german-occupied_europe_SOC	sociology
logical_form_(linguistics)_ANTHRO	anthropology
lerner_paradox_ECON	economics
no_war_but_the_class_war_POLISCY	political_science
merger_simulation_ECON	economics
law_of_the_jungle_SOC	sociology
(don't)_touch_me_on_my_studio_POLISCY	political_science
biorhythm_(pseudoscience)_PSY	psychology
applied_anthropology_research_methods_ANTHRO	anthropology
might_makes_right_POLISCY	political_science
regulatory_competition_POLISCY	political_science
fragmentation_(sociology)_SOC	sociology
hereditarianism_PSY	psychology
resource_conservation_and_recovery_act_POLISCY	political_science
social_multiplier_effect_SOC	sociology
sympathetic_magic_ANTHRO	anthropology
idée_fixe_(psychology)_PSY	psychology
political_man_POLISCY	political_science
sex_and_reason_ECON	economics
instrumental_and_intrinsic_value_SOC	sociology
enterprise_theory_POLISCY	political_science
psychological_evaluation_PSY	psychology
michael_thrasher_POLISCY	political_science
disability_anthropology_ANTHRO	anthropology
economics_(textbook)_ECON	economics
impossible_trinity_ECON	economics
seasoned_equity_offering_ECON	economics
politics_of_memory_POLISCY	political_science
categorical_perception_PSY	psychology
taxation_in_uruguay_ECON	economics
societal_attitudes_towards_abortion_POLISCY	political_science
egosyntonic_and_egodystonic_PSY	psychology
canadian_political_science_association_POLISCY	political_science
superrationality_ECON	economics
intensity_of_preference_ECON	economics
friedrich_naumann_foundation_POLISCY	political_science
cumulative_prospect_theory_ECON	economics
causa_sui_PSY	psychology
fiscal_policy_of_the_philippines_POLISCY	political_science
darwinian_anthropology_ANTHRO	anthropology
efficiency_wage_ECON	economics
porter_hypothesis_SOC	sociology
crying_PSY	psychology
magical_death_ANTHRO	anthropology
scitovsky_paradox_ECON	economics
political_culture_of_germany_POLISCY	political_science
ministry_of_housing_and_works_(pakistan)_POLISCY	political_science
all_animals_are_equal,_but_some_animals_are_more_equal_than_others_POLISCY	political_science
consumption_(sociology)_SOC	sociology
post-politics_POLISCY	political_science
corporate_communication_POLISCY	political_science
unearned_income_POLISCY	political_science
samuelson_condition_ECON	economics
convex_preferences_ECON	economics
kyklos_POLISCY	political_science
diplomatic_protection_POLISCY	political_science
deviationism_POLISCY	political_science
armchair_theorizing_ECON	economics
electronic_process_of_law_POLISCY	political_science
qem_ECON	economics
hobbesian_trap_SOC	sociology
international_relations_and_security_network_POLISCY	political_science
west_pride_SOC	sociology
hoi_polloi_ANTHRO	anthropology
conflict_resolution_research_SOC	sociology
hong_kong_honours_system_ANTHRO	anthropology
vaticanology_POLISCY	political_science
independent_labour_publications_POLISCY	political_science
parochialism_POLISCY	political_science
present_age_POLISCY	political_science
constitutionality_POLISCY	political_science
food_bank_SOC	sociology
inside_contracting_ECON	economics
archery_SOC	sociology
coppieters_foundation_POLISCY	political_science
phillip_blond_POLISCY	political_science
exocannibalism_ANTHRO	anthropology
voluntary_sector_ECON	economics
argentine_forensic_anthropology_team_ANTHRO	anthropology
oryx_and_crake_POLISCY	political_science
guanche_mummies_ANTHRO	anthropology
simulation_modeling_ECON	economics
sociometric_status_PSY	psychology
political_journalism_SOC	sociology
federal_law_POLISCY	political_science
taboo_(2002_tv_series)_ANTHRO	anthropology
new_political_economy_(journal)_POLISCY	political_science
foreign_service_officer_POLISCY	political_science
mass_media_and_american_politics_POLISCY	political_science
market-dominant_minority_SOC	sociology
fordisc_ANTHRO	anthropology
outworker_ECON	economics
reterritorialization_ANTHRO	anthropology
molon_labe_POLISCY	political_science
tryphé_POLISCY	political_science
marlon_bundo_POLISCY	political_science
ministry_of_infrastructure_and_water_management_POLISCY	political_science
ash-shab_yurid_isqat_an-nizam_POLISCY	political_science
gloss_(annotation)_ANTHRO	anthropology
passing_(sociology)_SOC	sociology
they_shall_not_pass_POLISCY	political_science
economics_handbooks_ECON	economics
journal_of_policy_history_POLISCY	political_science
american_system_of_manufacturing_ECON	economics
julia's_on_broadway_SOC	sociology
deployment_management_POLISCY	political_science
altered_states_PSY	psychology
numbers_(vancouver)_SOC	sociology
structural_estimation_ECON	economics
two-sided_matching_ECON	economics
wyn_grant_POLISCY	political_science
united_federal_workers_of_america_POLISCY	political_science
the_morals_of_chess_SOC	sociology
social_service_review_SOC	sociology
black_eagle_(montreal)_SOC	sociology
robert_christison_POLISCY	political_science
nonprofit_and_voluntary_sector_quarterly_SOC	sociology
bureaucratic_drift_POLISCY	political_science
ernest_barker_POLISCY	political_science
gevald_campaign_POLISCY	political_science
open_energy_system_databases_POLISCY	political_science
ministry_of_land,_infrastructure,_transport_and_tourism_POLISCY	political_science
elif_shafak_POLISCY	political_science
nonkilling_global_political_science_POLISCY	political_science
analytical_sociology_SOC	sociology
list_of_economics_films_ECON	economics
expansionary_fiscal_contraction_POLISCY	political_science
politics_(academic_journal)_POLISCY	political_science
alexandra_goujon_POLISCY	political_science
eric_helleiner_POLISCY	political_science
domestic_analogy_POLISCY	political_science
hemline_index_ECON	economics
museum_of_world_culture_ANTHRO	anthropology
political_studies_(journal)_POLISCY	political_science
sociologists_without_borders_SOC	sociology
iza_institute_of_labor_economics_ECON	economics
richard_koo_ECON	economics
guttman_scale_PSY	psychology
marie-christine_kessler_POLISCY	political_science
raisons_politiques_POLISCY	political_science
local_service_delivery_POLISCY	political_science
shrunken_head_ANTHRO	anthropology
quaternary_sector_of_the_economy_ECON	economics
marriage_of_the_virgin_ANTHRO	anthropology
security_of_tenure_POLISCY	political_science
india_quarterly_POLISCY	political_science
repeatability_PSY	psychology
keep_indy_indie_POLISCY	political_science
malinda_s._smith_POLISCY	political_science
ljiljana_radonić_POLISCY	political_science
joe_biden_(the_onion)_POLISCY	political_science
indirect_inference_ECON	economics
immigrant-host_model_SOC	sociology
nonna_mayer_POLISCY	political_science
western_cape_department_of_transport_and_public_works_POLISCY	political_science
neutral_stimulus_PSY	psychology
institut_d'études_politiques_d'aix-en-provence_POLISCY	political_science
suzanne_kessler_SOC	sociology
dynamic_discrete_choice_ECON	economics
biblical_patriarchy_ANTHRO	anthropology
maritza_montero_POLISCY	political_science
pierre-andré_chiappori_ECON	economics
party_political_broadcast_POLISCY	political_science
journal_of_lesbian_studies_SOC	sociology
jihad_satire_POLISCY	political_science
human_resource_management_in_public_administration_POLISCY	political_science
jane_duckett_POLISCY	political_science
feldstein–horioka_puzzle_ECON	economics
yelyzaveta_yasko_POLISCY	political_science
official_bilingualism_in_the_public_service_of_canada_POLISCY	political_science
glory_to_ukraine_POLISCY	political_science
build–operate–transfer_POLISCY	political_science
how_voters_feel_POLISCY	political_science
women's_week_provincetown_SOC	sociology
henry_habib_POLISCY	political_science
doing_gender_SOC	sociology
donald_e._stokes_POLISCY	political_science
moderation_theory_POLISCY	political_science
sustainability_standards_and_certification_SOC	sociology
private_highway_ECON	economics
greatness_SOC	sociology
skew_ECON	economics
social_organism_SOC	sociology
democracies:_patterns_of_majoritarian_&_consensus_government_in_twenty-one_countries_POLISCY	political_science
carbon_bubble_ECON	economics
ioana_marinescu_ECON	economics
moana_(1926_film)_ANTHRO	anthropology
making_peace_POLISCY	political_science
ngo-ization_POLISCY	political_science
aversives_PSY	psychology
arab_barometer_POLISCY	political_science
benjamin_moll_ECON	economics
gustav_stolper_prize_ECON	economics
les_maîtres_fous_ANTHRO	anthropology
against_equality_of_opportunity_POLISCY	political_science
horace_campbell_POLISCY	political_science
kaarlo_juho_ståhlberg_POLISCY	political_science
headhunting_ANTHRO	anthropology
common_informer_POLISCY	political_science
rena_dourou_POLISCY	political_science
multistakeholder_governance_POLISCY	political_science
clarita_carlos_POLISCY	political_science
archibald_crossley_POLISCY	political_science
school_of_public_policy_at_central_european_university_POLISCY	political_science
kim_campbell_POLISCY	political_science
classification_of_advocacy_groups_POLISCY	political_science
fred_w._riggs_POLISCY	political_science
frank_batten_school_of_leadership_and_public_policy_POLISCY	political_science
cultural_survival_ANTHRO	anthropology
australian_institute_of_aboriginal_and_torres_strait_islander_studies_ANTHRO	anthropology
east_turkestan_POLISCY	political_science
safety-valve_institution_SOC	sociology
volatility_clustering_ECON	economics
adaptive_capacity_SOC	sociology
post-work_society_SOC	sociology
backus–kehoe–kydland_puzzle_ECON	economics
charlie_bean_(economist)_ECON	economics
norman_chester_POLISCY	political_science
paul_van_riper_(political_scientist)_POLISCY	political_science
transitology_POLISCY	political_science
the_theory_of_interstellar_trade_ECON	economics
the_final_days_(2000_film)_POLISCY	political_science
demonstration_effect_SOC	sociology
price_support_ECON	economics
spin_room_POLISCY	political_science
andré_du_pisani_POLISCY	political_science
attorney-general_v_de_keyser's_royal_hotel_ltd_POLISCY	political_science
new_aspects_of_politics_POLISCY	political_science
rowman_&_littlefield_award_in_innovative_teaching_POLISCY	political_science
passing_on_the_right_POLISCY	political_science
behavioral_public_administration_POLISCY	political_science
petitions_of_right_(ireland)_act_1873_POLISCY	political_science
freelancer_ECON	economics
politeia_(journal)_POLISCY	political_science
grotesque_body_PSY	psychology
ursula_apitzsch_POLISCY	political_science
svetlana_tatunts_POLISCY	political_science
knowledge_gap_hypothesis_POLISCY	political_science
european_federation_of_psychologists'_associations_PSY	psychology
environmental_racism_in_the_united_states_SOC	sociology
debate_chamber_POLISCY	political_science
holocaust_trivialization_POLISCY	political_science
average_variable_cost_ECON	economics
cabin_fever_PSY	psychology
ariane_chebel_d'appollonia_POLISCY	political_science
katharine_hayhoe_POLISCY	political_science
viola_klein_SOC	sociology
rosa_brooks_POLISCY	political_science
jewish-palestinian_living_room_dialogue_group_POLISCY	political_science
sacralism_POLISCY	political_science
john_coakley_POLISCY	political_science
theories_of_humor_PSY	psychology
international_conference_on_theory_and_practice_of_electronic_governance_POLISCY	political_science
peace–industrial_complex_POLISCY	political_science
robin_hood_effect_POLISCY	political_science
hill_people_ANTHRO	anthropology
adaptive_unconscious_PSY	psychology
advocacy_journalism_POLISCY	political_science
the_crisis_of_democracy_POLISCY	political_science
cura_annonae_ECON	economics
east_european_politics_POLISCY	political_science
international_general_medical_society_for_psychotherapy_PSY	psychology
eustress_PSY	psychology
average_fixed_cost_ECON	economics
security_sector_governance_and_reform_POLISCY	political_science
digest_of_middle_east_studies_POLISCY	political_science
german_sociological_association_SOC	sociology
international_journal_of_intelligence_and_counterintelligence_POLISCY	political_science
yehuda_zvi_blum_POLISCY	political_science
world_politics_POLISCY	political_science
secular_variation_ECON	economics
victim_study_POLISCY	political_science
postfunctionalism_POLISCY	political_science
critique:_journal_of_socialist_theory_POLISCY	political_science
sequential_probability_ratio_test_PSY	psychology
songun_ECON	economics
is_the_glass_half_empty_or_half_full?_PSY	psychology
jensen_prize_ECON	economics
valence_issue_POLISCY	political_science
occupatio_POLISCY	political_science
fukoku_kyōhei_POLISCY	political_science
gnosis_(chaos_magic)_PSY	psychology
groupism_SOC	sociology
world3_ECON	economics
wisconsin_school_(diplomatic_history)_POLISCY	political_science
overview_of_21st-century_propaganda_POLISCY	political_science
ethnoscape_ANTHRO	anthropology
moralia_ANTHRO	anthropology
shale_band_ECON	economics
perestroika_movement_(political_science)_POLISCY	political_science
black_tax_SOC	sociology
international_workers'_day_POLISCY	political_science
carles_boix_POLISCY	political_science
international_convention_concerning_the_use_of_broadcasting_in_the_cause_of_peace_POLISCY	political_science
the_machiavellian_moment_POLISCY	political_science
1910s_in_anthropology_ANTHRO	anthropology
ministry_of_magic_POLISCY	political_science
energy_superpower_POLISCY	political_science
proclamation_by_the_crown_act_1539_POLISCY	political_science
economic_law_ECON	economics
sustainability_and_environmental_management_SOC	sociology
woman,_culture,_and_society_ANTHRO	anthropology
marginal_return_ECON	economics
renata_salecl_SOC	sociology
elective_dictatorship_POLISCY	political_science
industry_(economics)_ECON	economics
das_mutterrecht_ANTHRO	anthropology
nonpartisanism_POLISCY	political_science
laura_boulton_ANTHRO	anthropology
¿por_qué_no_te_callas?_POLISCY	political_science
term_(time)_ECON	economics
journal_of_sociology_SOC	sociology
sleep-learning_PSY	psychology
society_of_anthropology_of_paris_ANTHRO	anthropology
list_of_mnemonics_PSY	psychology
centre_for_health_and_international_relations_POLISCY	political_science
commodity_chain_ECON	economics
paul_de_grauwe_ECON	economics
principle-policy_puzzle_POLISCY	political_science
volume_index_ECON	economics
organizational_adaptation_SOC	sociology
supreme_court_economic_review_ECON	economics
principles_of_political_economy_(malthus_book)_POLISCY	political_science
motivational_salience_PSY	psychology
small_office/home_office_POLISCY	political_science
sociological_imagination_SOC	sociology
leontief_production_function_ECON	economics
historical_behaviour_studies_ANTHRO	anthropology
the_permanent_revolution_and_results_and_prospects_POLISCY	political_science
list_of_cycles_PSY	psychology
law_of_effect_PSY	psychology
metanoia_(psychology)_ANTHRO	anthropology
cabang_atas_ANTHRO	anthropology
paleoradiology_ANTHRO	anthropology
primakov_readings_POLISCY	political_science
noel_ignatiev_SOC	sociology
thucydides_trap_POLISCY	political_science
human_genetic_clustering_ANTHRO	anthropology
giancarlo_corsetti_ECON	economics
music_and_political_warfare_POLISCY	political_science
relative_income_hypothesis_ECON	economics
barbara_rogoff_PSY	psychology
high_policing_POLISCY	political_science
lila:_an_inquiry_into_morals_ANTHRO	anthropology
roman_question_POLISCY	political_science
biocultural_diversity_ANTHRO	anthropology
democratic_party_for_a_new_society_POLISCY	political_science
consequentialist_justifications_of_the_state_POLISCY	political_science
educational_anthropology_ANTHRO	anthropology
1990s_in_anthropology_ANTHRO	anthropology
nigel_simmonds_POLISCY	political_science
tobacco-free_pharmacy_POLISCY	political_science
rajputisation_SOC	sociology
social_situation_in_the_french_suburbs_SOC	sociology
vent_for_surplus_ECON	economics
foundation_for_european_economic_development_ECON	economics
analytic_frame_SOC	sociology
designing_social_inquiry_POLISCY	political_science
neil_maccormick_POLISCY	political_science
job_cohen_POLISCY	political_science
violence_peace_and_peace_research_POLISCY	political_science
status_quo_state_POLISCY	political_science
list_of_national_independence_days_POLISCY	political_science
intergenerational_policy_POLISCY	political_science
earned_media_POLISCY	political_science
journal_of_the_american_psychoanalytic_association_PSY	psychology
feeling_good:_the_new_mood_therapy_PSY	psychology
science_&_diplomacy_POLISCY	political_science
long-run_cost_curve_ECON	economics
auspicious_wedding_dates_ANTHRO	anthropology
intergroup_anxiety_SOC	sociology
index_of_psychometrics_articles_PSY	psychology
viking_fund_medal_ANTHRO	anthropology
ecological_economics_(journal)_ECON	economics
hicks-neutral_technical_change_ECON	economics
the_engineering_of_consent_POLISCY	political_science
radical_egalitarianism_POLISCY	political_science
dollar_voting_ECON	economics
paradoxical_intention_PSY	psychology
self-defeating_prophecy_PSY	psychology
media_linguistics_ANTHRO	anthropology
macroeconomic_regulation_and_control_ECON	economics
bloc_party_(politics)_POLISCY	political_science
theory_x_and_theory_y_PSY	psychology
contest_mobility_SOC	sociology
stylized_fact_ECON	economics
eugen_relgis_SOC	sociology
cultural_resource_management_ANTHRO	anthropology
venture_capital_in_spaceflight_ECON	economics
gotai_ANTHRO	anthropology
institutional_trust_(social_sciences)_SOC	sociology
proactive_law_POLISCY	political_science
slain_in_the_spirit_PSY	psychology
corner_solution_ECON	economics
leslie_green_(philosopher)_POLISCY	political_science
public_budgeting_POLISCY	political_science
museo_nacional_de_antropología_(madrid)_ANTHRO	anthropology
dynamic_density_SOC	sociology
aparna_rao_ANTHRO	anthropology
transfer_(propaganda)_PSY	psychology
joint_product_pricing_ECON	economics
transliminality_PSY	psychology
choosing_scotland's_future_POLISCY	political_science
keynes–ramsey_rule_ECON	economics
proportionality_bias_PSY	psychology
bioregionalism_SOC	sociology
displacement_(linguistics)_ANTHRO	anthropology
menninger_foundation_PSY	psychology
theta_criterion_ANTHRO	anthropology
duality_of_structure_SOC	sociology
task_analysis_PSY	psychology
backward_bending_supply_curve_of_labour_ECON	economics
commodity_form_theory_POLISCY	political_science
pork_cycle_ECON	economics
identity_line_ECON	economics
participatory_theory_PSY	psychology
official_cantonese_translations_of_english_names_for_british_officials_ANTHRO	anthropology
intertemporal_equilibrium_ECON	economics
encouraged_industry_catalogue_ECON	economics
regional_hegemony_POLISCY	political_science
public_engagement_POLISCY	political_science
asset_specificity_ECON	economics
symbolic_power_SOC	sociology
overlapping_consensus_POLISCY	political_science
mass_action_(sociology)_SOC	sociology
domestic_trade_POLISCY	political_science
list_of_jewish_american_economists_ECON	economics
lectures_on_jurisprudence_POLISCY	political_science
rossville_points_ANTHRO	anthropology
school_of_diplomacy_POLISCY	political_science
political_jurisprudence_POLISCY	political_science
richard_gaskin_ANTHRO	anthropology
direct_historical_approach_ANTHRO	anthropology
commercialism_ECON	economics
spatial_justice_POLISCY	political_science
chaîne_opératoire_ANTHRO	anthropology
grab_em_by_the_pussy_POLISCY	political_science
internality_ECON	economics
social_rule_system_theory_SOC	sociology
social_geometry_SOC	sociology
he_who_does_not_work,_neither_shall_he_eat_POLISCY	political_science
richard_timberlake_ECON	economics
economic_humanitarianism_(raëlianism)_ECON	economics
agonism_SOC	sociology
kiyotaki–moore_model_ECON	economics
culture_21_POLISCY	political_science
political_socialization_POLISCY	political_science
harvey_jackins_PSY	psychology
weak_and_strong_sustainability_ECON	economics
ithaca_hours_ECON	economics
economic_graph_ECON	economics
biological_organisation_POLISCY	political_science
david_marks_(psychologist)_PSY	psychology
swiss_neutrality_POLISCY	political_science
interventionism_(politics)_POLISCY	political_science
secondary_deviance_SOC	sociology
civilizing_the_economy_ECON	economics
gochisosama_SOC	sociology
harvest_hills_cooperative_community_POLISCY	political_science
regulatory_economics_POLISCY	political_science
liberal_legalism_POLISCY	political_science
ethnarch_POLISCY	political_science
market_mechanism_ECON	economics
john_murray_cuddihy_SOC	sociology
problems_with_economic_models_ECON	economics
matrix_of_domination_SOC	sociology
catonism_POLISCY	political_science
administrative_divisions_of_portugal_POLISCY	political_science
the_establishment_(pakistan)_POLISCY	political_science
net_national_product_ECON	economics
ralph_borsodi_POLISCY	political_science
political_research_associates_POLISCY	political_science
national_agrarian_party_POLISCY	political_science
middlebrow_ANTHRO	anthropology
geography_of_antisemitism_ANTHRO	anthropology
public_consultation_POLISCY	political_science
bevanism_POLISCY	political_science
seek_truth_from_facts_POLISCY	political_science
peruvian_nitrate_monopoly_POLISCY	political_science
continuismo_POLISCY	political_science
danish_defence_agreement_2013–2017_POLISCY	political_science
vertical_farming_ECON	economics
private_sphere_SOC	sociology
mentalization_PSY	psychology
in_place_of_strife_POLISCY	political_science
fiscal_imbalance_POLISCY	political_science
list_of_timothy_asch_films_ANTHRO	anthropology
denationalized_citizenship_POLISCY	political_science
local_multiplier_effect_ECON	economics
cipp_evaluation_model_POLISCY	political_science
rosa_luxemburg_foundation_POLISCY	political_science
grace_skogstad_POLISCY	political_science
stochastic_investment_model_ECON	economics
energy_certificate_POLISCY	political_science
slapsoftware_POLISCY	political_science
market_for_corporate_control_ECON	economics
colin_rallings_POLISCY	political_science
off_the_verandah_ANTHRO	anthropology
investment_arbitration_ECON	economics
verbal_self-defense_SOC	sociology
lowell_l._bennion_SOC	sociology
distributive_tendency_POLISCY	political_science
mummy_of_san_andrés_ANTHRO	anthropology
criticism_of_the_federal_reserve_ECON	economics
maddaddam_POLISCY	political_science
endocannibalism_ANTHRO	anthropology
cephalic_index_in_cats_and_dogs_ANTHRO	anthropology
benefit_financing_model_ECON	economics
canadian_honours_system_ANTHRO	anthropology
the_witch-cult_in_western_europe_ANTHRO	anthropology
consumption_distribution_ECON	economics
day_of_empire_POLISCY	political_science
red_wall_(us_politics)_POLISCY	political_science
post-cognitivist_psychology_PSY	psychology
guatemalan_forensic_anthropology_foundation_ANTHRO	anthropology
maturity_transformation_ECON	economics
la_borde_clinic_PSY	psychology
squirrel_(debate)_POLISCY	political_science
self-assessment_PSY	psychology
electronic_funds_transfer_ECON	economics
rethinking_economics_ECON	economics
the_elephant_curve_ECON	economics
commentary_on_palestine:_peace_not_apartheid_POLISCY	political_science
norwegian_journal_of_sociology_SOC	sociology
jane_semeleer_ECON	economics
rivers_state_civil_service_POLISCY	political_science
tripartite_consultation_(international_labour_standards)_convention,_1976_POLISCY	political_science
tax-allocation_district_ECON	economics
minsky's_burlesque_PSY	psychology
summerhill_(book)_SOC	sociology
releasing_the_spirits:_a_balinese_ceremony_ANTHRO	anthropology
emilia_justyna_powell_POLISCY	political_science
vocational_panel_POLISCY	political_science
school_of_politics_and_international_relations,_university_of_nottingham_POLISCY	political_science
middle-range_theory_(sociology)_SOC	sociology
china_watcher_POLISCY	political_science
the_civic_culture_POLISCY	political_science
lloyd–la_follette_act_POLISCY	political_science
paola_giuliano_ECON	economics
institute_for_international_economic_studies_ECON	economics
sock_puppet_account_PSY	psychology
university_of_tennessee_anthropological_research_facility_ANTHRO	anthropology
exclusive_federal_powers_POLISCY	political_science
oskar_pfister_award_PSY	psychology
ümit_cizre_POLISCY	political_science
kansas_city_preventive_patrol_experiment_POLISCY	political_science
archon_fung_POLISCY	political_science
inter-municipal_cooperation_POLISCY	political_science
franciscan_school_of_theology_POLISCY	political_science
social_impact_entertainment_POLISCY	political_science
spearman_medal_PSY	psychology
australian_quarterly_POLISCY	political_science
davis–moore_hypothesis_SOC	sociology
men's_underwear_index_ECON	economics
decentralized_computing_POLISCY	political_science
bps_barbara_wilson_lifetime_achievement_award_PSY	psychology
kissinger_lecture_POLISCY	political_science
debtocracy_ECON	economics
principle_of_inalienability_of_the_public_domain_POLISCY	political_science
corn_exchange_ECON	economics
analytic_induction_SOC	sociology
reichsministerium_des_innern_POLISCY	political_science
wilson–patterson_conservatism_scale_POLISCY	political_science
statecraft_(political_science)_POLISCY	political_science
sailing_ship_effect_ECON	economics
american_political_thought_POLISCY	political_science
social_media_in_the_2020_united_states_presidential_election_POLISCY	political_science
un-energy_POLISCY	political_science
core_self-evaluations_PSY	psychology
political_alienation_POLISCY	political_science
kenneth_boulding's_evolutionary_perspective_ECON	economics
apprehension_(understanding)_PSY	psychology
obshchestvovedeniye_SOC	sociology
humanistic_coefficient_SOC	sociology
powering_past_coal_alliance_POLISCY	political_science
unevenly_spaced_time_series_ECON	economics
duck_curve_ECON	economics
pilar_calveiro_POLISCY	political_science
josepha_laroche_POLISCY	political_science
priya_kurian_POLISCY	political_science
democratic_recession_POLISCY	political_science
global_environmental_politics_POLISCY	political_science
uk_heo_POLISCY	political_science
caucus_for_a_new_political_science_POLISCY	political_science
robert_kent_gooch_POLISCY	political_science
sam_potolicchio_POLISCY	political_science
bonai_state_POLISCY	political_science
journal_of_ethnic_and_migration_studies_POLISCY	political_science
big_man_(political_science)_POLISCY	political_science
rodney_tiffen_POLISCY	political_science
open_philanthropy_(doctrine)_POLISCY	political_science
gruppi_di_acquisto_solidale_POLISCY	political_science
democracy_and_security_POLISCY	political_science
canadian_public_policy_POLISCY	political_science
dominic_boyer_ANTHRO	anthropology
time-use_research_ECON	economics
mediations_(journal)_POLISCY	political_science
minimal_effects_hypothesis_POLISCY	political_science
joint_organisations_data_initiative_ECON	economics
the_good_society_POLISCY	political_science
david_e._campbell_(political_scientist)_POLISCY	political_science
tortured_artist_PSY	psychology
journal_of_current_chinese_affairs_POLISCY	political_science
rené-könig-gesellschaft_SOC	sociology
afke_schaart_POLISCY	political_science
policy_studies_journal_POLISCY	political_science
ishraga_mustafa_hamid_POLISCY	political_science
fascism:_a_warning_POLISCY	political_science
inclusion_and_democracy_POLISCY	political_science
international_journal_of_public_opinion_research_POLISCY	political_science
social_media_use_in_african_politics_POLISCY	political_science
catherine_wihtol_de_wenden_POLISCY	political_science
analysis_of_rhythmic_variance_ECON	economics
boosterism_POLISCY	political_science
fundacion_manantiales_POLISCY	political_science
policy_sciences_POLISCY	political_science
philip_oxhorn_POLISCY	political_science
her_majesty's_government_(term)_POLISCY	political_science
nobody_nowhere_PSY	psychology
brigitte_young_POLISCY	political_science
critical_review_(journal)_POLISCY	political_science
wallace_neutrality_ECON	economics
alex_brillantes_jr._POLISCY	political_science
trusteeship_(gandhism)_POLISCY	political_science
time_warp_edit_distance_ECON	economics
polarized_pluralism_POLISCY	political_science
doncaster_pride_SOC	sociology
insight_turkey_POLISCY	political_science
no_war,_no_peace_POLISCY	political_science
environmental_politics_(journal)_POLISCY	political_science
al-ahram_center_for_political_and_strategic_studies_POLISCY	political_science
computational_politics_POLISCY	political_science
list_of_scientific_occupations_SOC	sociology
grey_room_POLISCY	political_science
open_music_model_ECON	economics
public_opinion_on_nuclear_issues_POLISCY	political_science
argumentation_and_advocacy_POLISCY	political_science
fiscal_transparency_POLISCY	political_science
international_review_of_the_red_cross_POLISCY	political_science
election_law_journal_POLISCY	political_science
lorena_parini_POLISCY	political_science
steven_b._smith_(professor)_POLISCY	political_science
praxis:_the_fletcher_journal_of_human_security_POLISCY	political_science
institute_for_political_studies_–_catholic_university_of_portugal_POLISCY	political_science
janet_ajzenstat_POLISCY	political_science
frieda_fromm-reichmann_PSY	psychology
applied_psychological_measurement_PSY	psychology
political_geography_(journal)_POLISCY	political_science
niamh_reilly_POLISCY	political_science
jean_bethke_elshtain_POLISCY	political_science
journal_of_european_integration_POLISCY	political_science
risk,_hazards_&_crisis_in_public_policy_POLISCY	political_science
indian_economic_and_social_history_review_SOC	sociology
linked_fate_POLISCY	political_science
extemporaneous_speaking_POLISCY	political_science
the_castle_(novel)_POLISCY	political_science
international_association_of_art_critics_PSY	psychology
journal_of_european_social_policy_POLISCY	political_science
william_james_booth_POLISCY	political_science
alternatives:_turkish_journal_of_international_relations_POLISCY	political_science
programme_for_economic_advancement_and_community_empowerment_SOC	sociology
enbau_POLISCY	political_science
political_criticism_POLISCY	political_science
michael_l._gross_(ethicist)_POLISCY	political_science
akademie_für_soziologie_SOC	sociology
research_in_social_stratification_and_mobility_SOC	sociology
twitter_diplomacy_POLISCY	political_science
demand_shaping_ECON	economics
drought_tolerance_ECON	economics
liquidity_premium_ECON	economics
market-based_valuation_ECON	economics
cand.scient.pol._POLISCY	political_science
robert_ekelund_ECON	economics
louise_dandurand_POLISCY	political_science
fiscal_capacity_POLISCY	political_science
journal_of_current_southeast_asian_affairs_POLISCY	political_science
käthe_leichter_ECON	economics
green_institute_foundation_POLISCY	political_science
tiocfaidh_ár_lá_POLISCY	political_science
parallel_state_POLISCY	political_science
jhai_foundation_ECON	economics
margaret_clark_(political_scientist)_POLISCY	political_science
andrew_westmoreland_POLISCY	political_science
politics,_philosophy_&_economics_POLISCY	political_science
curvilinear_disparity_POLISCY	political_science
second-order_election_POLISCY	political_science
constitutional_autochthony_POLISCY	political_science
pi_sigma_alpha_POLISCY	political_science
list_of_food_labeling_regulations_POLISCY	political_science
science_&_society_POLISCY	political_science
making_democracy_work_POLISCY	political_science
sophomore_surge_POLISCY	political_science
gate_crashing_ANTHRO	anthropology
free_newfoundland_POLISCY	political_science
kurt_heinrich_wolff_SOC	sociology
cyranoid_PSY	psychology
gwendolen_m._carter_POLISCY	political_science
w._meredith_bacon_POLISCY	political_science
jerzy_adam_kowalski_ANTHRO	anthropology
small_media,_big_revolution_POLISCY	political_science
weston_a._price_foundation_ECON	economics
cube_root_rule_POLISCY	political_science
united_nations_office_on_drugs_and_crime_POLISCY	political_science
the_hidden_hand:_middle_east_fears_of_conspiracy_POLISCY	political_science
rasma_kārkliņa_POLISCY	political_science
factor_endowment_ECON	economics
real-time_economy_ECON	economics
nicole_bacharan_POLISCY	political_science
marian_van_landingham_POLISCY	political_science
interviewer_effect_POLISCY	political_science
work,_employment_&_society_SOC	sociology
pal_lahara_state_POLISCY	political_science
cost-weighted_activity_index_ECON	economics
andrea_weber_ECON	economics
pauline_barrieu_ECON	economics
research_excellence_framework_POLISCY	political_science
contemporary_voices_POLISCY	political_science
anthropometric_history_ANTHRO	anthropology
lag_operator_ECON	economics
boris_maciejovsky_PSY	psychology
bureau-shaping_model_POLISCY	political_science
stephen_barber_POLISCY	political_science
carmen_a._miró_SOC	sociology
black_hole_bomb_ECON	economics
matrix_management_SOC	sociology
environmental_peacebuilding_POLISCY	political_science
res_publica_christiana_POLISCY	political_science
the_end_of_liberalism_POLISCY	political_science
ministry_of_infrastructure_(ukraine)_POLISCY	political_science
dixit–stiglitz_model_ECON	economics
el_centro_integrado_de_technologia_appropriada_ECON	economics
dyab_abou_jahjah_POLISCY	political_science
valérie_igounet_POLISCY	political_science
inertial_inflation_ECON	economics
politique_africaine_POLISCY	political_science
yakama_manty_jones_ECON	economics
ecological_imperialism_SOC	sociology
quadrilateral_security_dialogue_POLISCY	political_science
european_school_of_political_and_social_sciences_POLISCY	political_science
journal_of_political_ideologies_POLISCY	political_science
requisite_organization_SOC	sociology
print_capitalism_POLISCY	political_science
centre_for_appropriate_technology_(australia)_ECON	economics
joan_roughgarden_ANTHRO	anthropology
list_of_rugrats_characters_POLISCY	political_science
resource_justice_SOC	sociology
snackwell_effect_PSY	psychology
why_zebras_don't_get_ulcers_PSY	psychology
liberal_democratic_basic_order_POLISCY	political_science
late_trading_ECON	economics
political_methodology_POLISCY	political_science
english_votes_for_english_laws_POLISCY	political_science
party-state_capitalism_ECON	economics
j_curve_ECON	economics
dominium_maris_baltici_POLISCY	political_science
gabor–granger_method_ECON	economics
performative_interval_SOC	sociology
national_student_survey_POLISCY	political_science
writ_POLISCY	political_science
organigraph_SOC	sociology
after_saturday_comes_sunday_POLISCY	political_science
saskia_wieringa_SOC	sociology
graduate_program_in_public_management_POLISCY	political_science
peter_jaeckel_ECON	economics
gladstone_professor_of_government_POLISCY	political_science
ethnopediatrics_ANTHRO	anthropology
sectoral_output_ECON	economics
i_like_ike_POLISCY	political_science
the_state_(book)_SOC	sociology
george_hilton_(historian)_ECON	economics
child_behavior_checklist_PSY	psychology
taftian_theory_POLISCY	political_science
colin_hughes_POLISCY	political_science
occupational_closure_SOC	sociology
francesco_caselli_ECON	economics
probability_matching_PSY	psychology
linguistic_system_ANTHRO	anthropology
in_defense_of_the_national_interest_POLISCY	political_science
corporate_anniversary_POLISCY	political_science
3g_(countries)_ECON	economics
list_of_countries_by_labour_force_SOC	sociology
angst_und_vorurteil_SOC	sociology
preference_theory_SOC	sociology
patient_participation_POLISCY	political_science
public_opinion_and_activism_in_the_terri_schiavo_case_POLISCY	political_science
prague_conference_POLISCY	political_science
ogilvie_professor_of_human_geography_ANTHRO	anthropology
ap_comparative_government_and_politics_POLISCY	political_science
bipu_ECON	economics
maxims_of_islamic_law_POLISCY	political_science
martine-anstett_award_SOC	sociology
james–lange_theory_PSY	psychology
beatrice_heuser_POLISCY	political_science
limitarianism_(ethical)_POLISCY	political_science
béla_balassa_ECON	economics
influence:_science_and_practice_PSY	psychology
timo_teräsvirta_ECON	economics
nancy_program_POLISCY	political_science
institute_for_international_law_of_peace_and_armed_conflict_POLISCY	political_science
gestalt_theoretical_psychotherapy_PSY	psychology
christian_fuchs_(sociologist)_SOC	sociology
ipm_(software)_POLISCY	political_science
character_computing_PSY	psychology
time_&_society_SOC	sociology
tore_ellingsen_ECON	economics
comparative_criminal_justice_POLISCY	political_science
sensory_threshold_PSY	psychology
imaginary_audience_PSY	psychology
left_group_of_finnish_workers_POLISCY	political_science
global_social_policy_SOC	sociology
strategic_choice_theory_SOC	sociology
ernst_borinski_SOC	sociology
global_retirement_index_ECON	economics
the_good_soldier_švejk_POLISCY	political_science
latin_american_public_opinion_project_POLISCY	political_science
the_lexus_and_the_olive_tree_SOC	sociology
selectorate_theory_POLISCY	political_science
revisionist_school_of_islamic_studies_SOC	sociology
sybil_(schreiber_book)_PSY	psychology
farshid_jamshidian_ECON	economics
peace_through_strength_POLISCY	political_science
utinahica_ANTHRO	anthropology
the_freudian_coverup_PSY	psychology
obshchina_ECON	economics
åland_islands_peace_institute_POLISCY	political_science
special_relationship_(international_relations)_POLISCY	political_science
life-process_model_of_addiction_SOC	sociology
anti-gender_campaigns_in_europe_SOC	sociology
randy_david_SOC	sociology
marginal_propensity_to_import_ECON	economics
sovereignty_of_the_philippines_POLISCY	political_science
friction_of_distance_ANTHRO	anthropology
moving_anthropology_student_network_ANTHRO	anthropology
sodality_(social_anthropology)_ANTHRO	anthropology
reasoned_action_approach_PSY	psychology
information_metabolism_PSY	psychology
usc_center_for_visual_anthropology_ANTHRO	anthropology
critique_of_modernity_SOC	sociology
maloca_ANTHRO	anthropology
marc_lynch_POLISCY	political_science
titicut_follies_PSY	psychology
cognized_environment_ANTHRO	anthropology
roper_center_for_public_opinion_research_POLISCY	political_science
hoplology_ANTHRO	anthropology
sociological_insight_SOC	sociology
relational_developmental_systems_PSY	psychology
census_of_india_prior_to_independence_ANTHRO	anthropology
waking_the_tiger_PSY	psychology
international_area_studies_review_POLISCY	political_science
paid_survey_POLISCY	political_science
electronic_media_POLISCY	political_science
sexual_jihad_POLISCY	political_science
behavioral_pharmacology_PSY	psychology
sustainable_development_goal_17_SOC	sociology
bishop–cannings_theorem_ECON	economics
nayakrishi_ECON	economics
blau_space_SOC	sociology
alternative_financial_service_ECON	economics
authority_(sociology)_SOC	sociology
civilian-based_defense_SOC	sociology
regionalisation_POLISCY	political_science
lipstick_index_ECON	economics
contemporary_jewry_SOC	sociology
orthograde_posture_ANTHRO	anthropology
cornell-peru_project_ANTHRO	anthropology
children's_geographies_ANTHRO	anthropology
ecodynamics_ECON	economics
the_province_of_jurisprudence_determined_POLISCY	political_science
values_modes_POLISCY	political_science
ed_miliband_bacon_sandwich_photograph_POLISCY	political_science
squib_(writing)_ANTHRO	anthropology
performative_activism_SOC	sociology
conspicuous_conservation_PSY	psychology
paul_ferdinand_schilder_PSY	psychology
autonomous_communities_administration_POLISCY	political_science
inventory_bounce_ECON	economics
lambda_alpha_ANTHRO	anthropology
data_editing_POLISCY	political_science
2000s_in_anthropology_ANTHRO	anthropology
vanua_ANTHRO	anthropology
gay,_straight,_and_the_reason_why_ANTHRO	anthropology
sustainable_development_goal_14_SOC	sociology
1890s_in_anthropology_ANTHRO	anthropology
brocard_(law)_POLISCY	political_science
tropical_geography_ANTHRO	anthropology
gaonburha_ANTHRO	anthropology
blue_justice_SOC	sociology
sustainable_development_goal_11_SOC	sociology
right_to_the_city_POLISCY	political_science
tonograph_ANTHRO	anthropology
musée_des_confluences_ANTHRO	anthropology
british_polling_council_POLISCY	political_science
science_capital_SOC	sociology
craig_stanford_ANTHRO	anthropology
jamiat-e_islami_POLISCY	political_science
delmos_jones_SOC	sociology
life_and_how_to_survive_it_PSY	psychology
digital_ecosystem_SOC	sociology
anthrobotics_ANTHRO	anthropology
social_welfare_in_luxembourg_POLISCY	political_science
frazer_lecture_ANTHRO	anthropology
racial_literacy_SOC	sociology
karl_schwedler_POLISCY	political_science
specialist_in_psychology_PSY	psychology
identity_economics_ECON	economics
hypnodermatology_PSY	psychology
publicity_stunt_POLISCY	political_science
field_theory_(psychology)_PSY	psychology
martti_olavi_siirala_ANTHRO	anthropology
substitutes_for_leadership_theory_SOC	sociology
gestaltzerfall_PSY	psychology
split_labor_market_theory_ECON	economics
contrast_set_ANTHRO	anthropology
eviatar_zerubavel_SOC	sociology
encyclopedia_of_anthropology_ANTHRO	anthropology
the_democratic_paradox_POLISCY	political_science
mesosociology_SOC	sociology
nominative_determinism_PSY	psychology
anti-modernization_SOC	sociology
norwegian_sociology_canon_SOC	sociology
museu_da_lourinhã_ANTHRO	anthropology
naturalistic_observation_PSY	psychology
infant_industry_argument_ECON	economics
contingent_claim_analysis_ECON	economics
global_social_mobility_index_ECON	economics
list_of_credentials_in_psychology_PSY	psychology
universe_(economics)_ECON	economics
status–income_disequilibrium_SOC	sociology
health_policy_in_bangladesh_POLISCY	political_science
solano_people_ANTHRO	anthropology
militarized_interstate_dispute_POLISCY	political_science
economic_satiation_ECON	economics
delegated_authority_SOC	sociology
warrior_(character_class)_ANTHRO	anthropology
cumulative_process_ECON	economics
walras's_law_ECON	economics
list_of_special_economic_zones_ECON	economics
university_of_chicago_institute_of_politics_POLISCY	political_science
lump-sum_tax_ECON	economics
supreme_court_of_justice_of_colombia_POLISCY	political_science
drang_nach_osten_POLISCY	political_science
market_rate_ECON	economics
gallowglass_ANTHRO	anthropology
list_of_stateless_societies_ANTHRO	anthropology
market_microstructure_ECON	economics
new_york_state_sociological_association_SOC	sociology
sustainable_development_goal_12_SOC	sociology
five_stages_of_grief_PSY	psychology
valerie_bryson_POLISCY	political_science
correspondence_principle_(sociology)_SOC	sociology
ucla_luskin_school_of_public_affairs_POLISCY	political_science
national_association_of_school_psychologists_PSY	psychology
marcellina_(gnostic)_POLISCY	political_science
joseph_rowntree_foundation_POLISCY	political_science
toothpaste_tube_theory_ECON	economics
internal_family_systems_model_PSY	psychology
postpartum_confinement_ANTHRO	anthropology
marginal_factor_cost_ECON	economics
psychoinformatics_PSY	psychology
cognitive_intervention_PSY	psychology
border_outpost_POLISCY	political_science
racial_threat_SOC	sociology
hau_(anthropology)_ANTHRO	anthropology
social_construction_of_the_body_SOC	sociology
oliver_lepsius_POLISCY	political_science
precautionary_demand_ECON	economics
state_of_affairs_(sociology)_SOC	sociology
multidimensional_aptitude_battery_ii_PSY	psychology
silence=death_project_SOC	sociology
murfee_POLISCY	political_science
harvard_institute_of_politics_POLISCY	political_science
male_state_ANTHRO	anthropology
podom_ANTHRO	anthropology
social_risk_positions_SOC	sociology
international_peacekeeping_POLISCY	political_science
abnormal_profit_ECON	economics
multiliteracy_POLISCY	political_science
colonial_origins_of_comparative_development_ECON	economics
you_have_two_cows_POLISCY	political_science
nomads_of_the_longbow_ANTHRO	anthropology
logophonetic_ANTHRO	anthropology
nw_39th_street_enclave_SOC	sociology
social_death_SOC	sociology
just-noticeable_difference_PSY	psychology
social_balance_theory_SOC	sociology
starve_the_beast_ECON	economics
who_moved_my_cheese?_PSY	psychology
honorary_male_ANTHRO	anthropology
public_affairs_quarterly_POLISCY	political_science
tschandala_SOC	sociology
stakeholder_(corporate)_POLISCY	political_science
linguistic_linked_open_data_ANTHRO	anthropology
singleton_(global_governance)_POLISCY	political_science
neural_adaptation_PSY	psychology
electronic_authentication_POLISCY	political_science
sid_parnes_PSY	psychology
w._kip_viscusi_ECON	economics
ferdinand_tönnies_society_SOC	sociology
national_agricultural_policy_center_ECON	economics
evolutionary_studies_institute_ANTHRO	anthropology
learning_economy_ECON	economics
georg_pfeffer_ANTHRO	anthropology
eternity_clause_POLISCY	political_science
sociology_of_manchester_SOC	sociology
memory_space_(social_science)_SOC	sociology
generative_actor_SOC	sociology
kinder,_küche,_kirche_POLISCY	political_science
endocast_ANTHRO	anthropology
society_for_philosophy_and_psychology_PSY	psychology
neolinguistics_ANTHRO	anthropology
economic_base_analysis_ECON	economics
label_(sociology)_SOC	sociology
winner-take-all_politics_POLISCY	political_science
benevolence_and_the_mandate_of_heaven_POLISCY	political_science
heide_göttner-abendroth_ANTHRO	anthropology
mundell–tobin_effect_ECON	economics
worshipful_company_of_butchers_POLISCY	political_science
how_are_we_to_live?_PSY	psychology
americanoid_ANTHRO	anthropology
village_head_ANTHRO	anthropology
capital_(marxism)_SOC	sociology
norm_entrepreneur_SOC	sociology
l'empire_de_la_honte_ECON	economics
maya_research_program_ANTHRO	anthropology
catherine_eschle_POLISCY	political_science
market_allocation_scheme_ECON	economics
administrative_divisions_of_peru_POLISCY	political_science
survey_on_household_income_and_wealth_ECON	economics
urban_village_POLISCY	political_science
leipzig_school_(sociology)_SOC	sociology
sarnoff_a._mednick_PSY	psychology
preclusive_purchasing_ECON	economics
technobiophilia_PSY	psychology
arif_ahmed_(philosopher)_ECON	economics
wilson_doctrine_(economics)_ECON	economics
deep_play:_notes_on_the_balinese_cockfight_ANTHRO	anthropology
financial_innovation_ECON	economics
daphne_dorman_SOC	sociology
bad_governance_POLISCY	political_science
waga_sculpture_ANTHRO	anthropology
jenkins_activity_survey_PSY	psychology
dizzy_with_success_POLISCY	political_science
harris–todaro_model_ECON	economics
mars_needs_moms_ANTHRO	anthropology
google_finance_ECON	economics
the_indian_struggle_POLISCY	political_science
sociologists_for_women_in_society_SOC	sociology
the_reformation_in_economics_ECON	economics
pseudodysphagia_PSY	psychology
michelle_rosaldo_book_prize_ANTHRO	anthropology
public_comment_POLISCY	political_science
housing_affordability_index_ECON	economics
society_for_economic_anthropology_ANTHRO	anthropology
this_machine_kills_fascists_POLISCY	political_science
richard_rottenburg_SOC	sociology
concession_(contract)_SOC	sociology
class_traitor_POLISCY	political_science
unipolar_mania_PSY	psychology
policy_sociology_SOC	sociology
indian_political_philosophy_POLISCY	political_science
obliviousness_PSY	psychology
jurisprudence_of_concepts_POLISCY	political_science
salvador_minguijón_adrián_POLISCY	political_science
science_in_action_(book)_SOC	sociology
hawaiian_ethnobiology_ANTHRO	anthropology
productive_capacity_ECON	economics
flourish_of_approval_SOC	sociology
multimodal_anthropology_ANTHRO	anthropology
output_elasticity_ECON	economics
ad–ia_model_ECON	economics
chicago_school_(sociology)_SOC	sociology
gerald_shove_ECON	economics
magna_carta_for_philippine_internet_freedom_POLISCY	political_science
forward_exchange_market_ECON	economics
anthropological_survey_of_india_ANTHRO	anthropology
conservative_research_department_POLISCY	political_science
history_of_dyslexia_research_PSY	psychology
foreclosure_rescue_ECON	economics
sharon_oster_ECON	economics
protest_cycle_SOC	sociology
oikofobie._de_angst_voor_het_eigene_ANTHRO	anthropology
land_consolidation_POLISCY	political_science
kalahari_debate_ANTHRO	anthropology
thumos_PSY	psychology
public_image_of_cristina_fernández_de_kirchner_POLISCY	political_science
say's_political_economy_POLISCY	political_science
mental_environment_PSY	psychology
coercion,_capital,_and_european_states,_ad_990–1992_POLISCY	political_science
backlash_(sociology)_SOC	sociology
modular_cognition_framework_PSY	psychology
national_forum_(georgia)_POLISCY	political_science
economic_evaluation_of_time_ECON	economics
online_research_methods_SOC	sociology
brandalism_POLISCY	political_science
list_of_enlightened_despots_POLISCY	political_science
institutional_analysis_POLISCY	political_science
ap_microeconomics_ECON	economics
moor's_head_(heraldry)_SOC	sociology
social_rights_(social_contract_theory)_SOC	sociology
disordered_eating_PSY	psychology
svoboda_ili_smart_POLISCY	political_science
beveridge_curve_ECON	economics
alphons_silbermann_SOC	sociology
triangle_model_ECON	economics
clustering_(demographics)_SOC	sociology
encyclopedia_of_women_and_islamic_cultures_SOC	sociology
eric_french_(professor)_ECON	economics
democratic_marxism_POLISCY	political_science
journal_of_behavioral_and_experimental_economics_ECON	economics
regional_autonomy_POLISCY	political_science
word_gap_SOC	sociology
loopco_ECON	economics
journal_of_ethnobiology_ANTHRO	anthropology
gender_and_development_SOC	sociology
public_image_of_narendra_modi_POLISCY	political_science
organization_&_environment_SOC	sociology
the_journal_of_political_philosophy_POLISCY	political_science
communist_correspondence_committee_SOC	sociology
vulnerable_adult_SOC	sociology
proprietary_community_POLISCY	political_science
liberal_social_movement_(portugal)_POLISCY	political_science
indonesian_village_law_POLISCY	political_science
grave_candle_SOC	sociology
better_red_than_dead_POLISCY	political_science
games_for_change_SOC	sociology
knowledge_assessment_methodology_ECON	economics
beatrice_cherrier_ECON	economics
feeding_the_chooks_POLISCY	political_science
das_argument_SOC	sociology
successor_ideology_POLISCY	political_science
pensions_crisis_POLISCY	political_science
